,word,wordcount_before,percentage_before,wordcount_onafter,percentage_onafter,wordcount_difference,percentage_difference
0,print,26521,0.0741918789252094,7936,0.0535691383441898,-18585,-27.79649320083774
1,silver,23150,0.0647615850502846,6083,0.0410611225488541,-17067,-36.59648305863439
2,lithograph,19429,0.0543521743387464,5159,0.0348239900097877,-14270,-35.92898456508945
3,gelatin,17189,0.0480858265844208,4863,0.0328259475513854,-12326,-31.734671351119943
4,paper,13559,0.0379309862504021,4669,0.0315164197239191,-8890,-16.911151437342337
5,printed,11898,0.0332843774915026,4161,0.0280873468561206,-7737,-15.61402383658455
6,one,11355,0.0317653476564139,4043,0.027290829930136,-7312,-14.08616009708438
7,etching,9643,0.0269760675870364,3835,0.025886800094502,-5808,-4.037903185925653
8,book,8189,0.0229085365000769,3579,0.0241587633737216,-4610,5.457471600774242
9,pencil,8167,0.022846992013204,3331,0.0224847278004657,-4836,-1.585610099259177
10,,7777,0.0217559761095491,3243,0.0218907151776975,-4534,0.619319801924504
11,illustrated,7359,0.0205866308589652,2910,0.019642917411995,-4449,-4.584108266356876
12,albumen,5874,0.0164323779950484,2468,0.0166593540112727,-3406,1.3812730956693857
13,ink,5679,0.015886870043221,2463,0.01662560329407,-3216,4.649960935283288
14,color,5532,0.0154756409718433,1980,0.0133652840122852,-3552,-13.636636850116432
15,black,5387,0.0150700068538178,1951,0.0131695298525093,-3436,-12.610989628229913
16,aquatint,5132,0.0143566503014281,1893,0.0127780215329575,-3239,-10.995801494959927
17,portfolio,5118,0.0143174856279635,1854,0.0125147659387762,-3264,-12.59103543757995
18,engraving,4832,0.0135174072986166,1788,0.0120692564717,-3044,-10.713229208272852
19,woodcut,4561,0.0127592911194102,1617,0.0109149819433662,-2944,-14.454636694027034
20,drypoint,4040,0.0113018057711943,1611,0.010874481082723,-2429,-3.7810301921879694
21,offset,3592,0.0100485362203292,1499,0.0101184650173816,-2093,0.6959102850316361
22,screenprint,3200,0.0089519253633222,1491,0.0100644638698572,-1709,12.42792428870429
23,letterpress,3161,0.0088428237729567,1190,0.0080326706942522,-1971,-9.16170105280314
24,wood,3099,0.0086693802190424,1183,0.0079854196901684,-1916,-7.889382073376729
25,including,2997,0.0083840375980865,1177,0.0079449188295251,-1820,-5.237557244037404
26,two,2153,0.0060229672835102,1081,0.0072969050592325,-1072,21.1513314908768
27,cover,2059,0.0057600044759626,1078,0.0072766546289108,-981,26.330711361031366
28,tracing,2047,0.0057264347558502,1059,0.0071484019035404,-988,24.83163099409279
29,watercolor,2007,0.0056145356888086,1056,0.0071281514732188,-951,26.958877248340873
30,addition,1895,0.0053012183010924,1003,0.0067703938708697,-892,27.713923221659307
31,reproduction,1860,0.005203306617431,998,0.006736643153667,-862,29.468502415355363
32,colored,1852,0.0051809268040227,971,0.0065543892807722,-881,26.509976471450692
33,gouache,1803,0.0050438504468968,900,0.0060751290964933,-903,20.446257486301725
34,oil,1711,0.0047864825927013,874,0.005899625367039,-837,23.25596620857001
35,canvas,1520,0.004252164547578,855,0.0057713726416686,-665,35.727876404875445
36,front,1341,0.0037514162225672,842,0.0056836207769415,-499,51.506003059613526
37,drawing,1319,0.0036898717356944,838,0.0056566202031793,-481,53.3012692137597
38,text,1314,0.0036758843523142,802,0.0054136150393195,-512,47.273812787698006
39,pen,1311,0.003667491922286,801,0.005406864895879,-510,47.42677040468639
40,photogravure,1286,0.0035975550053851,786,0.0053056127442708,-500,47.47829390597075
41,0,1284,0.003591960052033,767,0.0051773600189004,-517,44.13746099347864
42,wrapper,1266,0.0035416054718643,723,0.0048803537075162,-543,37.80060332206295
43,collotype,1239,0.0034660736016113,642,0.0043335920888318,-597,25.028853594372908
44,ten,1238,0.0034632761249353,616,0.0041580883593776,-622,20.06228234126957
45,cut,1236,0.0034576811715832,602,0.0040635863512099,-634,17.523454290878657
46,collage,1217,0.0034045291147385,591,0.0039893347733639,-626,17.177284696838857
47,lithographed,1146,0.0032059082707397,590,0.0039825846299233,-556,24.22640617238862
48,board,1142,0.0031947183640356,580,0.0039150831955179,-562,22.54861773080768
49,six,1099,0.0030744268669659,580,0.0039150831955179,-519,27.34351360198819
50,ground,1093,0.0030576420069097,562,0.003793580613588,-531,24.068828365623443
51,linoleum,1082,0.0030268697634733,547,0.0036923284619798,-535,21.985045624919564
52,five,1054,0.0029485404165442,542,0.003658577744777,-512,24.08097661638942
53,glass,1042,0.0029149706964318,520,0.003510074589085,-522,20.415433108184022
54,three,1035,0.0028953883596995,501,0.0033818218637146,-534,16.800285266933415
55,chromogenic,1031,0.0028841984529953,493,0.0033278207161902,-538,15.381128255380252
56,manuscript,970,0.002713552375757,492,0.0033210705727496,-478,22.38829817401703
57,supplementary,969,0.002710754899081,485,0.0032738195686658,-484,20.771507958011636
58,plastic,942,0.0026352230288279,481,0.0032468189949036,-461,23.20850870629067
59,containing,935,0.0026156406920957,456,0.0030780654088899,-479,17.67921405228241
60,crayon,931,0.0026044507853915,451,0.0030443146916871,-480,16.88893139247705
61,four,931,0.0026044507853915,422,0.0028485605319113,-509,9.37279167988216
62,page,916,0.002562488635251,394,0.0026595565155759,-522,3.7880316419585593
63,cutandpasted,901,0.0025205264851104,393,0.0026528063721354,-508,5.248105417912555
64,pochoir,891,0.00249255171835,388,0.0026190556549326,-503,5.075278304208741
65,eight,871,0.0024366021848292,387,0.0026123055114921,-484,7.2109976653910115
66,illustration,801,0.0022407788175066,363,0.0024503020689189,-438,9.35046555132311
67,steel,784,0.0021932217140139,363,0.0024503020689189,-421,11.721585340066099
68,block,776,0.0021708419006056,356,0.0024030510648351,-420,10.696733104549022
69,printingoutpaper,772,0.0021596519939015,352,0.0023760504910729,-420,10.020063314944887
70,line,761,0.002128879750465,349,0.0023558000607512,-412,10.65914174986329
71,paint,759,0.002123284797113,348,0.0023490499173107,-411,10.632823279508674
72,video,744,0.0020813226469724,337,0.0022747983394647,-407,9.29580489472594
73,suite,722,0.0020197781600995,330,0.0022275473353808,-392,10.28673244348105
74,series,722,0.0020197781600995,329,0.0022207971919403,-393,9.952530223957734
75,seven,720,0.0020141832067475,320,0.0021600459009753,-400,7.241778887797361
76,white,698,0.0019526387198746,312,0.002106044753451,-386,7.856344955929778
77,box,691,0.0019330563831424,307,0.0020722940362482,-384,7.202979401948609
78,poster,689,0.0019274614297903,300,0.0020250430321644,-389,5.06270065205488
79,nine,677,0.0018938917096778,295,0.0019912923149616,-382,5.142881442802795
80,soft,660,0.0018463346061852,291,0.0019642917411995,-369,6.388719283013228
81,sound,659,0.0018435371295091,276,0.0018630395895912,-383,1.0578826848631568
82,title,652,0.0018239547927769,272,0.001836039015829,-380,0.6625286492820553
83,negative,651,0.0018211573161008,269,0.0018157885855074,-382,-0.29479773910442403
84,embossing,642,0.0017959800260165,265,0.0017887880117452,-377,-0.4004506824751195
85,charcoal,628,0.0017568153525519,261,0.001761787437983,-367,0.2830169615650173
86,twelve,624,0.0017456254458478,259,0.0017482871511019,-365,0.15247860074628652
87,metal,623,0.0017428279691718,257,0.0017347868642208,-366,-0.4613825973209038
88,relief,616,0.0017232456324395,254,0.0017145364338992,-362,-0.5053950740598104
89,roulette,594,0.0016617011455666,253,0.0017077862904586,-341,2.7733714341447437
90,mm,593,0.0016589036688906,249,0.0016807857166964,-344,1.3190668160034769
91,film,591,0.0016533087155385,246,0.0016605352863748,-345,0.43709748629409895
92,painted,587,0.0016421188088344,242,0.0016335347126126,-345,-0.5227451372957006
93,eleven,548,0.0015330172184689,235,0.0015862837085288,-313,3.4746178593544967
94,felttip,537,0.0015022449750325,232,0.0015660332782071,-305,4.246198471938303
95,transfer,519,0.0014518903948638,228,0.0015390327044449,-291,6.001989536494918
96,sheet,518,0.0014490929181877,224,0.0015120321306827,-294,4.343352431375802
97,synthetic,512,0.0014323080581315,222,0.0014985318438016,-290,4.623571395422531
98,card,509,0.0014239156281034,219,0.00147828141348,-290,3.8180482258638473
99,eighteen,503,0.0014071307680472,213,0.0014377805528367,-290,2.1781760079083137
100,graphite,496,0.0013875484313149,211,0.0014242802659556,-285,2.6472470302093423
101,polymer,495,0.0013847509546389,211,0.0014242802659556,-284,2.8546152060251178
102,media,491,0.0013735610479347,209,0.0014107799790745,-282,2.7096670508939438
103,photolithograph,491,0.0013735610479347,208,0.001404029835634,-283,2.2182332372567735
104,twenty,482,0.0013483837578504,200,0.0013500286881096,-282,0.12199273757364179
105,platinum,481,0.0013455862811743,198,0.0013365284012285,-283,-0.6731548970531265
106,chine,453,0.0012672569342453,189,0.0012757771102635,-264,0.6723321678467699
107,matte,448,0.0012532695508651,188,0.001269026966823,-260,1.2573046195068769
108,mounted,430,0.0012029149706964,181,0.0012217759627392,-249,1.5679405861813216
109,lift,423,0.0011833326339641,179,0.0012082756758581,-244,2.1078639410494477
110,album,416,0.0011637502972318,178,0.0012015255324175,-238,3.2459914532830223
111,transparentized,408,0.0011413704838235,175,0.0011812751020959,-233,3.496202051653087
112,plate,389,0.0010882184269788,173,0.0011677748152148,-216,7.310700339533032
113,various,383,0.0010714335669226,171,0.0011542745283337,-212,7.731787015879863
114,doublesided,382,0.0010686360902465,169,0.0011407742414526,-213,6.750488015940041
115,fifteen,364,0.0010182815100779,166,0.0011205238111309,-198,10.040671468656868
116,halftone,357,0.0009986991733456,161,0.0010867730939282,-196,8.818863871445489
117,aluminum,356,0.0009959016966696,160,0.0010800229504876,-196,8.44674269552008
118,label,348,0.0009735218832612,156,0.0010530223767255,-192,8.166276981672082
119,photocopies,345,0.0009651294532331,152,0.0010260218029633,-193,6.309241680089224
120,postcard,340,0.0009511420698529,152,0.0010260218029633,-188,7.872612881268158
121,silkscreen,329,0.0009203698264165,145,0.0009787707988794,-184,6.345381039955076
122,object,328,0.0009175723497405,144,0.0009720206554389,-184,5.933952315999779
123,colophon,327,0.0009147748730644,144,0.0009720206554389,-183,6.257909356728677
124,ballpoint,322,0.0009007874896843,144,0.0009720206554389,-178,7.907876893313115
125,envelope,317,0.0008868001063041,143,0.0009652705119983,-174,8.848714060403038
126,photograph,314,0.0008784076762759,143,0.0009652705119983,-171,9.88866992723288
127,stamped,309,0.0008644202928958,143,0.0009652705119983,-166,11.666803744814077
128,folder,302,0.0008448379561635,143,0.0009652705119983,-159,14.255107142877103
129,twentytwo,300,0.0008392430028114,142,0.0009585203685578,-158,14.212494515513372
130,journal,300,0.0008392430028114,138,0.0009315197947956,-162,10.995241148878188
131,twentyeight,297,0.0008308505727833,135,0.0009112693644739,-162,9.679092044337384
132,rubber,295,0.0008252556194312,133,0.0008977690775928,-162,8.78678756669106
133,artist,294,0.0008224581427552,132,0.0008910189341523,-162,8.336082754001838
134,stamp,291,0.0008140657127271,131,0.0008842687907118,-160,8.6237605745022
135,collé,290,0.000811268236051,130,0.0008775186472712,-160,8.166276981665918
136,collaged,288,0.000805673282699,127,0.0008572682169496,-161,6.403952490239884
137,collagraph,286,0.0008000783293469,126,0.000850518073509,-160,6.304350750666339
138,dye,284,0.0007944833759948,125,0.0008437679300685,-159,6.2033461697029395
139,cotton,279,0.0007804959926146,123,0.0008302676431874,-156,6.376925832260707
140,acetate,277,0.0007749010392625,122,0.0008235174997468,-155,6.273892796758923
141,cardboard,276,0.0007721035625865,122,0.0008235174997468,-154,6.65894313297383
142,silent,275,0.0007693060859105,119,0.0008032670694252,-156,4.414495626211772
143,00,275,0.0007693060859105,119,0.0008032670694252,-156,4.414495626211772
144,stencil,271,0.0007581161792063,119,0.0008032670694252,-152,5.9556689933949505
145,thirteen,269,0.0007525212258542,116,0.0007830166391035,-153,4.052432303777771
146,pastel,269,0.0007525212258542,115,0.000776266495663,-154,3.155428577027358
147,back,266,0.0007441287958261,114,0.0007695163522224,-152,3.4117153560917926
148,fabric,265,0.0007413313191501,113,0.0007627662087819,-152,2.8914048385779783
149,sixteen,265,0.0007413313191501,112,0.0007560160653413,-153,1.9808614329197987
150,tempera,265,0.0007413313191501,111,0.0007492659219008,-154,1.070318027275118
151,typewriting,264,0.000738533842474,110,0.0007425157784602,-154,0.5391677073133035
152,rubberstamped,262,0.000732938889122,110,0.0007425157784602,-152,1.3066422699540834
153,glazed,260,0.0007273439357699,107,0.0007222653481386,-153,-0.6982374337010557
154,mixed,245,0.0006853817856293,107,0.0007222653481386,-138,5.381462315260461
155,graph,243,0.0006797868322772,106,0.000715515204698,-137,5.255820019507359
156,bronze,242,0.0006769893556012,106,0.000715515204698,-136,5.690761424540738
157,acrylic,238,0.000665799448897,104,0.000702014917817,-134,5.439396049365393
158,transferred,236,0.000660204495545,102,0.0006885146309359,-134,4.288085825215406
159,paperboard,234,0.0006546095421929,102,0.0006885146309359,-132,5.179436986118495
160,notebook,229,0.0006406221588127,102,0.0006885146309359,-127,7.4759312434589775
161,salted,228,0.0006378246821367,101,0.0006817644874953,-127,6.889009878294836
162,set,224,0.0006266347754325,101,0.0006817644874953,-123,8.797742197558325
163,photolithographic,223,0.0006238372987565,101,0.0006817644874953,-122,9.285624449558668
164,periodical,221,0.0006182423454044,100,0.0006750143440548,-121,9.182806559984932
165,vellum,220,0.0006154448687284,99,0.0006682642006142,-121,8.58230112388986
166,stainless,210,0.000587470101968,97,0.0006547639137331,-113,11.454848772672609
167,multiple,210,0.000587470101968,97,0.0006547639137331,-113,11.454848772672609
168,fifty,207,0.0005790776719399,96,0.0006480137702926,-111,11.904464926400168
169,conté,207,0.0005790776719399,95,0.000641263626852,-112,10.738793416741167
170,thirtyone,199,0.0005566978585316,93,0.0006277633399709,-106,12.765538855627936
171,tape,195,0.0005455079518274,92,0.0006210131965304,-103,13.8412729732105
172,fourteen,193,0.0005399129984753,92,0.0006210131965304,-101,15.020975283818853
173,porcelain,192,0.0005371155217993,92,0.0006210131965304,-100,15.620042863413936
174,nineteen,188,0.0005259256150951,91,0.0006142630530898,-97,16.796565038713034
175,hand,185,0.000517533185067,91,0.0006142630530898,-94,18.690563390689118
176,twentyfour,185,0.000517533185067,90,0.0006075129096493,-95,17.386271485306068
177,wash,184,0.000514735708391,89,0.0006007627662087,-95,16.712859903698906
178,twentyseven,184,0.000514735708391,89,0.0006007627662087,-95,16.712859903698906
179,twentysix,182,0.0005091407550389,88,0.0005940126227682,-94,16.669627581240363
180,calotype,182,0.0005091407550389,88,0.0005940126227682,-94,16.669627581240363
181,duplicate,178,0.0004979508483348,86,0.0005805123358871,-92,16.58024839768709
182,c,175,0.0004895584183066,86,0.0005805123358871,-89,18.578766941668118
183,seventeen,175,0.0004895584183066,85,0.0005737621924465,-90,17.199944070242697
184,inkjet,174,0.0004867609416306,82,0.0005535117621249,-92,13.713265544826061
185,vinyl,171,0.0004783685116025,82,0.0005535117621249,-89,15.70823511578459
186,plywood,168,0.0004699760815744,81,0.0005467616186843,-87,16.33817977559021
187,pigmented,168,0.0004699760815744,81,0.0005467616186843,-87,16.33817977559021
188,appliqué,167,0.0004671786048983,80,0.0005400114752438,-87,15.589941316202815
189,design,163,0.0004559886981942,80,0.0005400114752438,-83,18.426504293274334
190,record,162,0.0004531912215181,79,0.0005332613318033,-83,17.66806294636096
191,photocopy,158,0.000442001314814,79,0.0005332613318033,-79,20.647001248786665
192,variant,156,0.0004364063614619,79,0.0005332613318033,-77,22.193757675059896
193,metallic,155,0.0004336088847859,79,0.0005332613318033,-76,22.982104498759224
194,linen,151,0.0004224189780817,79,0.0005332613318033,-72,26.23990859145587
195,confirm,150,0.0004196215014057,79,0.0005332613318033,-71,27.08150798205413
196,chromeplated,148,0.0004140265480536,79,0.0005332613318033,-69,28.79882565749476
197,wire,146,0.0004084315947015,78,0.0005265111883627,-68,28.91049448500619
198,cloth,143,0.0004000391646734,78,0.0005265111883627,-65,31.614910453218826
199,exhibition,142,0.0003972416879974,78,0.0005265111883627,-64,32.5417760197782
200,intaglio,142,0.0003972416879974,77,0.0005197610449222,-65,30.84252248107501
201,brass,141,0.0003944442113213,77,0.0005197610449222,-64,31.770483633443757
202,note,139,0.0003888492579693,76,0.0005130109014816,-63,31.930533739658756
203,copy,136,0.0003804568279411,76,0.0005130109014816,-60,34.84076610159333
204,plexiglas,136,0.0003804568279411,74,0.0004995106146005,-62,31.292324888392127
205,wool,133,0.000372064397913,74,0.0004995106146005,-59,34.25380590090774
206,diazotype,128,0.0003580770145328,73,0.00049276047116,-55,37.612985799417444
207,lithography,126,0.0003524820611808,73,0.00049276047116,-53,39.79731890731495
208,table,126,0.0003524820611808,73,0.00049276047116,-53,39.79731890731495
209,paper\r\n,125,0.0003496845845047,72,0.0004860103277194,-53,38.98534543860273
210,smooth,124,0.0003468871078287,71,0.0004792601842789,-53,38.16027562360967
211,leather,123,0.0003440896311527,71,0.0004792601842789,-52,39.283529896957006
212,inch,122,0.0003412921544766,70,0.0004725100408383,-52,38.44737848220788
213,plaster,120,0.0003356972011245,70,0.0004725100408383,-50,40.75483479025499
214,chalk,119,0.0003328997244485,69,0.0004657598973978,-50,39.909967834729656
215,folded,117,0.0003273047710964,69,0.0004657598973978,-48,42.3015912165305
216,thirtytwo,116,0.0003245072944204,69,0.0004657598973978,-47,43.52832907182879
217,fiftysix,116,0.0003245072944204,69,0.0004657598973978,-47,43.52832907182879
218,iron,115,0.0003217098177443,68,0.0004590097539572,-47,42.67819278118151
219,material,114,0.0003189123410683,67,0.0004522596105167,-47,41.813141818755035
220,frame,114,0.0003189123410683,67,0.0004522596105167,-47,41.813141818755035
221,marker,114,0.0003189123410683,66,0.0004455094670761,-48,39.6965277617423
222,handwritten,113,0.0003161148643923,64,0.000432009180195,-49,36.66208991010134
223,diecut,113,0.0003161148643923,63,0.0004252590367545,-50,34.52674475527084
224,felttipped,112,0.0003133173877162,63,0.0004252590367545,-49,35.72787640489832
225,twentyone,111,0.0003105199110402,63,0.0004252590367545,-48,36.95065006618715
226,carbon,111,0.0003105199110402,62,0.0004185088933139,-49,34.776830223849856
227,serigraph,110,0.0003077224343642,62,0.0004185088933139,-48,36.00207413495905
228,monotype,110,0.0003077224343642,61,0.0004117587498734,-49,33.80849229408781
229,enamel,109,0.0003049249576881,61,0.0004117587498734,-48,35.03609314084996
230,panel,108,0.0003021274810121,59,0.0003982584629923,-49,31.818019882921543
231,bulletins,104,0.0002909375743079,58,0.0003915083195517,-46,34.56780908517704
232,pasted,104,0.0002909375743079,57,0.0003847581761112,-47,32.24767444579345
233,thirty,102,0.0002853426209558,57,0.0003847581761112,-45,34.84076610160513
234,super,100,0.0002797476676038,57,0.0003847581761112,-43,37.53758142360062
235,photostat,100,0.0002797476676038,57,0.0003847581761112,-43,37.53758142360062
236,piece,99,0.0002769501909277,56,0.0003780080326706,-43,36.48953676629958
237,slipcase,98,0.0002741527142517,56,0.0003780080326706,-42,37.882287141447115
238,photomontage,96,0.0002685577608996,56,0.0003780080326706,-40,40.754834790240096
239,typographic,95,0.0002657602842236,56,0.0003780080326706,-39,42.2364646301173
240,wetcollodion,94,0.0002629628075475,55,0.0003712578892301,-39,41.18266103583421
241,type,92,0.0002573678541955,55,0.0003712578892301,-37,44.25184931918016
242,gravure,92,0.0002573678541955,54,0.0003645077457895,-38,41.62908842244731
243,eightysix,91,0.0002545703775194,54,0.0003645077457895,-37,43.185452031520065
244,cast,91,0.0002545703775194,54,0.0003645077457895,-37,43.185452031520065
245,woodburytype,89,0.0002489754241674,54,0.0003645077457895,-35,46.403102638926
246,wove,89,0.0002489754241674,54,0.0003645077457895,-35,46.403102638926
247,eighty,88,0.0002461779474913,53,0.000357757602349,-35,45.32479695877036
248,newspaper,86,0.0002405829941392,53,0.000357757602349,-33,48.70444339968743
249,booklet,85,0.0002377855174632,53,0.000357757602349,-32,50.45390743966022
250,flocking,85,0.0002377855174632,52,0.0003510074589085,-33,47.61515446912043
251,lettering,83,0.0002321905641111,52,0.0003510074589085,-31,51.17214614309121
252,verso,83,0.0002321905641111,52,0.0003510074589085,-31,51.17214614309121
253,molded,81,0.000226595610759,52,0.0003510074589085,-29,54.90479172688853
254,thirtynine,80,0.000223798134083,52,0.0003510074589085,-28,56.84110162344869
255,red,80,0.000223798134083,51,0.0003442573154679,-29,53.82492659220532
256,x,79,0.000221000657407,51,0.0003442573154679,-28,55.77207756170049
257,thirtyeight,79,0.000221000657407,50,0.0003375071720274,-29,52.71772309972766
258,blue,78,0.0002182031807309,49,0.0003307570285868,-29,51.58212977413355
259,brown,78,0.0002182031807309,48,0.0003240068851463,-30,48.48861692162171
260,copper,78,0.0002182031807309,48,0.0003240068851463,-30,48.48861692162171
261,screenprinted,78,0.0002182031807309,48,0.0003240068851463,-30,48.48861692162171
262,lineblock,78,0.0002182031807309,48,0.0003240068851463,-30,48.48861692162171
263,pressuresensitive,78,0.0002182031807309,48,0.0003240068851463,-30,48.48861692162171
264,bolts,77,0.0002154057040549,47,0.0003172567417057,-30,47.28335217383168
265,recto,77,0.0002154057040549,46,0.0003105065982652,-31,44.14966382972935
266,silk,77,0.0002154057040549,46,0.0003105065982652,-31,44.14966382972935
267,gum,77,0.0002154057040549,46,0.0003105065982652,-31,44.14966382972935
268,tubular,77,0.0002154057040549,46,0.0003105065982652,-31,44.14966382972935
269,parts,75,0.0002098107507028,45,0.0003037564548246,-30,44.776401498546406
270,instant,75,0.0002098107507028,45,0.0003037564548246,-30,44.776401498546406
271,contents,75,0.0002098107507028,45,0.0003037564548246,-30,44.776401498546406
272,broadside,74,0.0002070132740268,44,0.0002970063113841,-30,43.47210959315075
273,seventytwo,73,0.0002042157973507,44,0.0002970063113841,-29,45.43748095748476
274,zinc,72,0.0002014183206747,44,0.0002970063113841,-28,47.457445970756076
275,palladium,70,0.0001958233673226,44,0.0002970063113841,-26,51.670515855654195
276,blown,70,0.0001958233673226,44,0.0002970063113841,-26,51.670515855654195
277,stone,70,0.0001958233673226,43,0.0002902561679435,-27,48.22345867708992
278,photomechanical,70,0.0001958233673226,42,0.000283506024503,-28,44.77640149857669
279,inkless,70,0.0001958233673226,42,0.000283506024503,-28,44.77640149857669
280,photographic,69,0.0001930258906466,42,0.000283506024503,-27,46.8746102159191
281,gold,69,0.0001930258906466,41,0.0002767558810624,-28,43.377595686941525
282,sixtyeight,69,0.0001930258906466,41,0.0002767558810624,-28,43.377595686941525
283,slide,67,0.0001874309372945,40,0.0002700057376219,-27,44.05612089409484
284,ivory,67,0.0001874309372945,40,0.0002700057376219,-27,44.05612089409484
285,nylon,67,0.0001874309372945,39,0.0002632555941813,-28,40.454717871714436
286,laminated,66,0.0001846334606185,39,0.0002632555941813,-27,42.58281965762068
287,polyethylene,66,0.0001846334606185,38,0.0002565054507408,-28,38.92684992283491
288,abs,66,0.0001846334606185,38,0.0002565054507408,-28,38.92684992283491
289,photo,66,0.0001846334606185,38,0.0002565054507408,-28,38.92684992283491
290,twentyfive,65,0.0001818359839424,38,0.0002565054507408,-27,41.06418607554211
291,foam,65,0.0001818359839424,38,0.0002565054507408,-27,41.06418607554211
292,case,64,0.0001790385072664,38,0.0002565054507408,-26,43.26831398294292
293,ornament,64,0.0001790385072664,38,0.0002565054507408,-26,43.26831398294292
294,presstype,64,0.0001790385072664,37,0.0002497553073002,-27,39.498095193888695
295,resin,63,0.0001762410305904,37,0.0002497553073002,-26,41.71235067312661
296,enameled,63,0.0001762410305904,37,0.0002497553073002,-26,41.71235067312661
297,overlay,62,0.0001734435539143,37,0.0002497553073002,-25,43.998033748551016
298,string,60,0.0001678486005622,37,0.0002497553073002,-23,48.797968206858926
299,thirtyfour,58,0.0001622536472102,37,0.0002497553073002,-21,53.92893262771553
300,ceramic,58,0.0001622536472102,37,0.0002497553073002,-21,53.92893262771553
301,blind,58,0.0001622536472102,36,0.0002430051638597,-22,49.768691205373166
302,thread,57,0.0001594561705341,35,0.0002362550204191,-22,48.16298398974557
303,score,57,0.0001594561705341,35,0.0002362550204191,-22,48.16298398974557
304,volume,57,0.0001594561705341,35,0.0002362550204191,-22,48.16298398974557
305,lacquered,57,0.0001594561705341,35,0.0002362550204191,-22,48.16298398974557
306,polyester,56,0.0001566586938581,35,0.0002362550204191,-21,50.80875156095558
307,\r\n,56,0.0001566586938581,34,0.0002295048769786,-22,46.49993008781461
308,gray,56,0.0001566586938581,34,0.0002295048769786,-22,46.49993008781461
309,fiftytwo,56,0.0001566586938581,34,0.0002295048769786,-22,46.49993008781461
310,newsprint,55,0.0001538612171821,34,0.0002295048769786,-21,49.16356518028396
311,casing,55,0.0001538612171821,34,0.0002295048769786,-21,49.16356518028396
312,casein,55,0.0001538612171821,34,0.0002295048769786,-21,49.16356518028396
313,etched,54,0.000151063740506,33,0.000222754733538,-21,47.45744597073085
314,bichromate,54,0.000151063740506,33,0.000222754733538,-21,47.45744597073085
315,base,54,0.000151063740506,33,0.000222754733538,-21,47.45744597073085
316,stapled,54,0.000151063740506,33,0.000222754733538,-21,47.45744597073085
317,cream,54,0.000151063740506,33,0.000222754733538,-21,47.45744597073085
318,birch,53,0.00014826626383,33,0.000222754733538,-20,50.23966193240522
319,brush,53,0.00014826626383,33,0.000222754733538,-20,50.23966193240522
320,ozalid,53,0.00014826626383,33,0.000222754733538,-20,50.23966193240522
321,embossed,52,0.0001454687871539,33,0.000222754733538,-19,53.12888620040164
322,polaroid,52,0.0001454687871539,33,0.000222754733538,-19,53.12888620040164
323,rod,51,0.0001426713104779,32,0.0002160045900975,-19,51.40015842986136
324,sand,51,0.0001426713104779,32,0.0002160045900975,-19,51.40015842986136
325,wooden,51,0.0001426713104779,32,0.0002160045900975,-19,51.40015842986136
326,wax,51,0.0001426713104779,32,0.0002160045900975,-19,51.40015842986136
327,applied,50,0.0001398738338019,32,0.0002160045900975,-18,54.42816159841747
328,mylar,50,0.0001398738338019,31,0.0002092544466569,-19,49.60228154842894
329,process,50,0.0001398738338019,31,0.0002092544466569,-19,49.60228154842894
330,torn,49,0.0001370763571258,31,0.0002092544466569,-18,52.65538933520062
331,lithographic,49,0.0001370763571258,31,0.0002092544466569,-18,52.65538933520062
332,photoetching,49,0.0001370763571258,30,0.0002025043032164,-19,47.73102193732388
333,rayon,49,0.0001370763571258,30,0.0002025043032164,-19,47.73102193732388
334,oak,48,0.0001342788804498,29,0.0001957541597758,-19,45.781793175571245
335,fortysix,48,0.0001342788804498,29,0.0001957541597758,-19,45.781793175571245
336,cellophane,48,0.0001342788804498,29,0.0001957541597758,-19,45.781793175571245
337,fortytwo,48,0.0001342788804498,29,0.0001957541597758,-19,45.781793175571245
338,bound,48,0.0001342788804498,29,0.0001957541597758,-19,45.781793175571245
339,lead,47,0.0001314814037737,29,0.0001957541597758,-18,48.883533455973335
340,crystal,47,0.0001314814037737,29,0.0001957541597758,-18,48.883533455973335
341,lined,47,0.0001314814037737,28,0.0001890040163353,-19,43.749618509249714
342,cardstock,47,0.0001314814037737,28,0.0001890040163353,-19,43.749618509249714
343,daguerreotype,46,0.0001286839270977,28,0.0001890040163353,-18,46.87461021593124
344,marble,46,0.0001286839270977,28,0.0001890040163353,-18,46.87461021593124
345,lacquer,46,0.0001286839270977,27,0.0001822538728947,-19,41.62908842246349
346,felt,46,0.0001286839270977,27,0.0001822538728947,-19,41.62908842246349
347,mirror,45,0.0001258864504217,27,0.0001822538728947,-18,44.77640149847572
348,correction,45,0.0001258864504217,27,0.0001822538728947,-18,44.77640149847572
349,mailed,45,0.0001258864504217,27,0.0001822538728947,-18,44.77640149847572
350,frottage,45,0.0001258864504217,27,0.0001822538728947,-18,44.77640149847572
351,forty,45,0.0001258864504217,26,0.0001755037294542,-19,39.41431255412305
352,light,45,0.0001258864504217,26,0.0001755037294542,-19,39.41431255412305
353,fluid,44,0.0001230889737456,26,0.0001755037294542,-18,42.58281965769793
354,bag,44,0.0001230889737456,26,0.0001755037294542,-18,42.58281965769793
355,mezzotint,44,0.0001230889737456,26,0.0001755037294542,-18,42.58281965769793
356,varnish,44,0.0001230889737456,26,0.0001755037294542,-18,42.58281965769793
357,perforated,44,0.0001230889737456,26,0.0001755037294542,-18,42.58281965769793
358,tom,43,0.0001202914970696,26,0.0001755037294542,-17,45.89869918457703
359,consilvio,43,0.0001202914970696,26,0.0001755037294542,-17,45.89869918457703
360,magnetic,43,0.0001202914970696,26,0.0001755037294542,-17,45.89869918457703
361,typewritten,43,0.0001202914970696,25,0.0001687535860137,-18,40.28721075443936
362,nail,42,0.0001174940203936,25,0.0001687535860137,-17,43.627382439023386
363,thirtysix,42,0.0001174940203936,25,0.0001687535860137,-17,43.627382439023386
364,twentythree,42,0.0001174940203936,25,0.0001687535860137,-17,43.627382439023386
365,foil,42,0.0001174940203936,24,0.0001620034425731,-18,37.88228714141819
366,ball,42,0.0001174940203936,24,0.0001620034425731,-18,37.88228714141819
367,musical,42,0.0001174940203936,24,0.0001620034425731,-18,37.88228714141819
368,xerox,42,0.0001174940203936,24,0.0001620034425731,-18,37.88228714141819
369,solvent,42,0.0001174940203936,24,0.0001620034425731,-18,37.88228714141819
370,bleach,42,0.0001174940203936,24,0.0001620034425731,-18,37.88228714141819
371,catalogue,42,0.0001174940203936,23,0.0001552532991326,-19,32.137191843898115
372,spray,41,0.0001146965437175,23,0.0001552532991326,-18,35.360050181627216
373,fiberglass,41,0.0001146965437175,23,0.0001552532991326,-18,35.360050181627216
374,bottle,41,0.0001146965437175,23,0.0001552532991326,-18,35.360050181627216
375,gesso,40,0.0001118990670415,23,0.0001552532991326,-17,38.74405143612254
376,photoengraving,40,0.0001118990670415,23,0.0001552532991326,-17,38.74405143612254
377,glitter,40,0.0001118990670415,23,0.0001552532991326,-17,38.74405143612254
378,animation,40,0.0001118990670415,22,0.000148503155692,-18,32.711701373635805
379,works,39,0.0001091015903654,22,0.000148503155692,-17,36.11456551149932
380,additional,39,0.0001091015903654,22,0.000148503155692,-17,36.11456551149932
381,blueprint,39,0.0001091015903654,22,0.000148503155692,-17,36.11456551149932
382,letter,38,0.0001063041136894,22,0.000148503155692,-16,39.696527761754766
383,laid,38,0.0001063041136894,22,0.000148503155692,-16,39.696527761754766
384,alloy,38,0.0001063041136894,22,0.000148503155692,-16,39.696527761754766
385,unknown,38,0.0001063041136894,22,0.000148503155692,-16,39.696527761754766
386,magazine,38,0.0001063041136894,22,0.000148503155692,-16,39.696527761754766
387,machine,37,0.0001035066370134,21,0.0001417530122515,-16,36.95065006618716
388,cm,37,0.0001035066370134,21,0.0001417530122515,-16,36.95065006618716
389,ornamental,37,0.0001035066370134,21,0.0001417530122515,-16,36.95065006618716
390,reel,37,0.0001035066370134,21,0.0001417530122515,-16,36.95065006618716
391,andor,37,0.0001035066370134,21,0.0001417530122515,-16,36.95065006618716
392,engraved,36,0.0001007091603373,21,0.0001417530122515,-15,40.754834790334804
393,pigment,36,0.0001007091603373,21,0.0001417530122515,-15,40.754834790334804
394,pinned,36,0.0001007091603373,21,0.0001417530122515,-15,40.754834790334804
395,frontispiece,36,0.0001007091603373,21,0.0001417530122515,-15,40.754834790334804
396,stoneware,36,0.0001007091603373,20,0.0001350028688109,-16,34.05222360979066
397,drafting,35,9.791168366133748e-05,20,0.0001350028688109,-15,37.882287141395324
398,sticker,35,9.791168366133748e-05,20,0.0001350028688109,-15,37.882287141395324
399,sleeve,35,9.791168366133748e-05,20,0.0001350028688109,-15,37.882287141395324
400,photogram,35,9.791168366133748e-05,20,0.0001350028688109,-15,37.882287141395324
401,mahogany,35,9.791168366133748e-05,20,0.0001350028688109,-15,37.882287141395324
402,veneer,35,9.791168366133748e-05,20,0.0001350028688109,-15,37.882287141395324
403,b,35,9.791168366133748e-05,20,0.0001350028688109,-15,37.882287141395324
404,screen,35,9.791168366133748e-05,20,0.0001350028688109,-15,37.882287141395324
405,pressed,35,9.791168366133748e-05,20,0.0001350028688109,-15,37.882287141395324
406,linocut,34,9.511420698529926e-05,19,0.0001282527253704,-15,34.84076610155894
407,leaf,34,9.511420698529926e-05,19,0.0001282527253704,-15,34.84076610155894
408,masking,34,9.511420698529926e-05,19,0.0001282527253704,-15,34.84076610155894
409,cassette,34,9.511420698529926e-05,19,0.0001282527253704,-15,34.84076610155894
410,tissue,34,9.511420698529926e-05,19,0.0001282527253704,-15,34.84076610155894
411,strip,34,9.511420698529926e-05,19,0.0001282527253704,-15,34.84076610155894
412,cutout,33,9.231673030926104e-05,19,0.0001282527253704,-14,38.92684992281831
413,goldtoned,33,9.231673030926104e-05,19,0.0001282527253704,-14,38.92684992281831
414,unbound,33,9.231673030926104e-05,19,0.0001282527253704,-14,38.92684992281831
415,without,33,9.231673030926104e-05,18,0.0001215025819298,-15,31.614910453139284
416,\r\n\r\n,33,9.231673030926104e-05,18,0.0001215025819298,-15,31.614910453139284
417,handle,33,9.231673030926104e-05,18,0.0001215025819298,-15,31.614910453139284
418,dry,33,9.231673030926104e-05,18,0.0001215025819298,-15,31.614910453139284
419,pictorial,32,8.951925363322283e-05,18,0.0001215025819298,-14,35.72787640479987
420,nickelplated,32,8.951925363322283e-05,18,0.0001215025819298,-14,35.72787640479987
421,bead,32,8.951925363322283e-05,18,0.0001215025819298,-14,35.72787640479987
422,upholstery,32,8.951925363322283e-05,18,0.0001215025819298,-14,35.72787640479987
423,polyurethane,32,8.951925363322283e-05,18,0.0001215025819298,-14,35.72787640479987
424,original,32,8.951925363322283e-05,17,0.0001147524384893,-15,28.18743882680509
425,woven,32,8.951925363322283e-05,17,0.0001147524384893,-15,28.18743882680509
426,motor,32,8.951925363322283e-05,17,0.0001147524384893,-15,28.18743882680509
427,handcolored,31,8.672177695718462e-05,17,0.0001147524384893,-14,32.322517498637495
428,open,31,8.672177695718462e-05,17,0.0001147524384893,-14,32.322517498637495
429,gummed,31,8.672177695718462e-05,17,0.0001147524384893,-14,32.322517498637495
430,paper\r\nb,31,8.672177695718462e-05,17,0.0001147524384893,-14,32.322517498637495
431,stereo,31,8.672177695718462e-05,17,0.0001147524384893,-14,32.322517498637495
432,latex,30,8.39243002811464e-05,17,0.0001147524384893,-13,36.73326808192543
433,walnut,29,8.11268236051082e-05,17,0.0001147524384893,-12,41.448208360612504
434,burlap,29,8.11268236051082e-05,17,0.0001147524384893,-12,41.448208360612504
435,coated,29,8.11268236051082e-05,17,0.0001147524384893,-12,41.448208360612504
436,yellow,29,8.11268236051082e-05,17,0.0001147524384893,-12,41.448208360612504
437,map,29,8.11268236051082e-05,17,0.0001147524384893,-12,41.448208360612504
438,mesh,29,8.11268236051082e-05,17,0.0001147524384893,-12,41.448208360612504
439,green,29,8.11268236051082e-05,17,0.0001147524384893,-12,41.448208360612504
440,boxes,29,8.11268236051082e-05,17,0.0001147524384893,-12,41.448208360612504
441,polished,29,8.11268236051082e-05,17,0.0001147524384893,-12,41.448208360612504
442,head,28,7.832934692906997e-05,17,0.0001147524384893,-11,46.499930087777244
443,lid,28,7.832934692906997e-05,17,0.0001147524384893,-11,46.499930087777244
444,border,28,7.832934692906997e-05,16,0.0001080022950487,-12,37.88228714136982
445,image,28,7.832934692906997e-05,16,0.0001080022950487,-12,37.88228714136982
446,vacuumformed,28,7.832934692906997e-05,16,0.0001080022950487,-12,37.88228714136982
447,tubing,28,7.832934692906997e-05,16,0.0001080022950487,-12,37.88228714136982
448,found,27,7.553187025303177e-05,16,0.0001080022950487,-11,42.989038516976095
449,photolithographed,27,7.553187025303177e-05,16,0.0001080022950487,-11,42.989038516976095
450,letraset,27,7.553187025303177e-05,16,0.0001080022950487,-11,42.989038516976095
451,carborundum,26,7.273439357699356e-05,16,0.0001080022950487,-10,48.48861692147517
452,tube,26,7.273439357699356e-05,16,0.0001080022950487,-10,48.48861692147517
453,china,26,7.273439357699356e-05,16,0.0001080022950487,-10,48.48861692147517
454,pewter,26,7.273439357699356e-05,16,0.0001080022950487,-10,48.48861692147517
455,cork,26,7.273439357699356e-05,16,0.0001080022950487,-10,48.48861692147517
456,selfadhesive,26,7.273439357699356e-05,16,0.0001080022950487,-10,48.48861692147517
457,issue,25,6.993691690095534e-05,16,0.0001080022950487,-9,54.42816159833419
458,cord,25,6.993691690095534e-05,16,0.0001080022950487,-9,54.42816159833419
459,costume,25,6.993691690095534e-05,15,0.0001012521516082,-10,44.77640149850086
460,pulp,25,6.993691690095534e-05,15,0.0001012521516082,-10,44.77640149850086
461,thirtyfive,25,6.993691690095534e-05,15,0.0001012521516082,-10,44.77640149850086
462,melamine,25,6.993691690095534e-05,15,0.0001012521516082,-10,44.77640149850086
463,clear,25,6.993691690095534e-05,15,0.0001012521516082,-10,44.77640149850086
464,chrome,25,6.993691690095534e-05,15,0.0001012521516082,-10,44.77640149850086
465,rope,24,6.713944022491713e-05,15,0.0001012521516082,-9,50.80875156093838
466,monoprint,24,6.713944022491713e-05,15,0.0001012521516082,-9,50.80875156093838
467,performance,24,6.713944022491713e-05,15,0.0001012521516082,-9,50.80875156093838
468,clipping,24,6.713944022491713e-05,15,0.0001012521516082,-9,50.80875156093838
469,unique,24,6.713944022491713e-05,15,0.0001012521516082,-9,50.80875156093838
470,wallpaper,24,6.713944022491713e-05,15,0.0001012521516082,-9,50.80875156093838
471,tin,24,6.713944022491713e-05,15,0.0001012521516082,-9,50.80875156093838
472,shell,24,6.713944022491713e-05,15,0.0001012521516082,-9,50.80875156093838
473,welded,24,6.713944022491713e-05,14,9.450200816767357e-05,-10,40.754834790239286
474,holes,24,6.713944022491713e-05,14,9.450200816767357e-05,-10,40.754834790239286
475,chicago,23,6.434196354887891e-05,14,9.450200816767357e-05,-9,46.87461021590188
476,audio,23,6.434196354887891e-05,14,9.450200816767357e-05,-9,46.87461021590188
477,construction,23,6.434196354887891e-05,14,9.450200816767357e-05,-9,46.87461021590188
478,blade,23,6.434196354887891e-05,14,9.450200816767357e-05,-9,46.87461021590188
479,cd,23,6.434196354887891e-05,14,9.450200816767357e-05,-9,46.87461021590188
480,digital,23,6.434196354887891e-05,14,9.450200816767357e-05,-9,46.87461021590188
481,medium,23,6.434196354887891e-05,14,9.450200816767357e-05,-9,46.87461021590188
482,handpainted,23,6.434196354887891e-05,14,9.450200816767357e-05,-9,46.87461021590188
483,glassine,23,6.434196354887891e-05,14,9.450200816767357e-05,-9,46.87461021590188
484,woodblock,23,6.434196354887891e-05,14,9.450200816767357e-05,-9,46.87461021590188
485,first,23,6.434196354887891e-05,14,9.450200816767357e-05,-9,46.87461021590188
486,transparency,22,6.15444868728407e-05,14,9.450200816767357e-05,-8,53.550728862079225
487,wall,22,6.15444868728407e-05,14,9.450200816767357e-05,-8,53.550728862079225
488,toned,22,6.15444868728407e-05,13,8.775186472712546e-05,-9,42.582819657645
489,fourcolor,22,6.15444868728407e-05,13,8.775186472712546e-05,-9,42.582819657645
490,cutandtaped,22,6.15444868728407e-05,13,8.775186472712546e-05,-9,42.582819657645
491,composition,22,6.15444868728407e-05,13,8.775186472712546e-05,-9,42.582819657645
492,beech,22,6.15444868728407e-05,13,8.775186472712546e-05,-9,42.582819657645
493,glued,21,5.874701019680249e-05,13,8.775186472712546e-05,-8,49.37247773658047
494,airbrushed,21,5.874701019680249e-05,13,8.775186472712546e-05,-8,49.37247773658047
495,teak,21,5.874701019680249e-05,13,8.775186472712546e-05,-8,49.37247773658047
496,top,21,5.874701019680249e-05,13,8.775186472712546e-05,-8,49.37247773658047
497,typed,21,5.874701019680249e-05,13,8.775186472712546e-05,-8,49.37247773658047
498,sandpaper,21,5.874701019680249e-05,13,8.775186472712546e-05,-8,49.37247773658047
499,sepia,21,5.874701019680249e-05,13,8.775186472712546e-05,-8,49.37247773658047
500,fiber,21,5.874701019680249e-05,13,8.775186472712546e-05,-8,49.37247773658047
501,minutes,21,5.874701019680249e-05,13,8.775186472712546e-05,-8,49.37247773658047
502,borosilicate,21,5.874701019680249e-05,13,8.775186472712546e-05,-8,49.37247773658047
503,folio,21,5.874701019680249e-05,13,8.775186472712546e-05,-8,49.37247773658047
504,powder,20,5.594953352076427e-05,13,8.775186472712546e-05,-7,56.84110162340949
505,lenticular,20,5.594953352076427e-05,13,8.775186472712546e-05,-7,56.84110162340949
506,incised,20,5.594953352076427e-05,13,8.775186472712546e-05,-7,56.84110162340949
507,stock,20,5.594953352076427e-05,13,8.775186472712546e-05,-7,56.84110162340949
508,airbrush,20,5.594953352076427e-05,13,8.775186472712546e-05,-7,56.84110162340949
509,cane,20,5.594953352076427e-05,13,8.775186472712546e-05,-7,56.84110162340949
510,twine,20,5.594953352076427e-05,13,8.775186472712546e-05,-7,56.84110162340949
511,concrete,20,5.594953352076427e-05,12,8.100172128657735e-05,-8,44.77640149853185
512,000,20,5.594953352076427e-05,12,8.100172128657735e-05,-8,44.77640149853185
513,diecast,19,5.315205684472606e-05,12,8.100172128657735e-05,-7,52.396212103717744
514,vhs,19,5.315205684472606e-05,12,8.100172128657735e-05,-7,52.396212103717744
515,polystyrene,19,5.315205684472606e-05,12,8.100172128657735e-05,-7,52.396212103717744
516,alkyd,19,5.315205684472606e-05,12,8.100172128657735e-05,-7,52.396212103717744
517,insert,19,5.315205684472606e-05,12,8.100172128657735e-05,-7,52.396212103717744
518,bulb,19,5.315205684472606e-05,12,8.100172128657735e-05,-7,52.396212103717744
519,scroll,19,5.315205684472606e-05,12,8.100172128657735e-05,-7,52.396212103717744
520,dust,19,5.315205684472606e-05,12,8.100172128657735e-05,-7,52.396212103717744
521,interior,19,5.315205684472606e-05,12,8.100172128657735e-05,-7,52.396212103717744
522,prints\r\n,19,5.315205684472606e-05,12,8.100172128657735e-05,-7,52.396212103717744
523,seat,19,5.315205684472606e-05,12,8.100172128657735e-05,-7,52.396212103717744
524,band,19,5.315205684472606e-05,12,8.100172128657735e-05,-7,52.396212103717744
525,sewn,18,5.035458016868784e-05,12,8.100172128657735e-05,-6,60.86266833170208
526,wrapped,18,5.035458016868784e-05,12,8.100172128657735e-05,-6,60.86266833170208
527,polacolor,18,5.035458016868784e-05,12,8.100172128657735e-05,-6,60.86266833170208
528,bent,18,5.035458016868784e-05,12,8.100172128657735e-05,-6,60.86266833170208
529,platinumpalladium,18,5.035458016868784e-05,12,8.100172128657735e-05,-6,60.86266833170208
530,scorper,18,5.035458016868784e-05,11,7.425157784602922e-05,-7,47.45744597072689
531,fiberglassreinforced,18,5.035458016868784e-05,11,7.425157784602922e-05,-7,47.45744597072689
532,untitled,18,5.035458016868784e-05,11,7.425157784602922e-05,-7,47.45744597072689
533,mulberry,17,4.755710349264963e-05,11,7.425157784602922e-05,-6,56.13141338076962
534,corrugated,17,4.755710349264963e-05,11,7.425157784602922e-05,-6,56.13141338076962
535,vinylcovered,17,4.755710349264963e-05,11,7.425157784602922e-05,-6,56.13141338076962
536,stained,17,4.755710349264963e-05,11,7.425157784602922e-05,-6,56.13141338076962
537,covered,17,4.755710349264963e-05,11,7.425157784602922e-05,-6,56.13141338076962
538,anodized,17,4.755710349264963e-05,11,7.425157784602922e-05,-6,56.13141338076962
539,electric,17,4.755710349264963e-05,11,7.425157784602922e-05,-6,56.13141338076962
540,music,17,4.755710349264963e-05,11,7.425157784602922e-05,-6,56.13141338076962
541,opaque,17,4.755710349264963e-05,11,7.425157784602922e-05,-6,56.13141338076962
542,finish,17,4.755710349264963e-05,11,7.425157784602922e-05,-6,56.13141338076962
543,beechwood,17,4.755710349264963e-05,11,7.425157784602922e-05,-6,56.13141338076962
544,chromed,17,4.755710349264963e-05,11,7.425157784602922e-05,-6,56.13141338076962
545,nickel,17,4.755710349264963e-05,11,7.425157784602922e-05,-6,56.13141338076962
546,art,16,4.4759626816611415e-05,10,6.750143440548111e-05,-6,50.80875156097066
547,proof,16,4.4759626816611415e-05,10,6.750143440548111e-05,-6,50.80875156097066
548,high,16,4.4759626816611415e-05,10,6.750143440548111e-05,-6,50.80875156097066
549,rock,16,4.4759626816611415e-05,10,6.750143440548111e-05,-6,50.80875156097066
550,rosewood,16,4.4759626816611415e-05,10,6.750143440548111e-05,-6,50.80875156097066
551,electrostatic,16,4.4759626816611415e-05,10,6.750143440548111e-05,-6,50.80875156097066
552,legs,16,4.4759626816611415e-05,10,6.750143440548111e-05,-6,50.80875156097066
553,onto,16,4.4759626816611415e-05,10,6.750143440548111e-05,-6,50.80875156097066
554,fiberboard,16,4.4759626816611415e-05,10,6.750143440548111e-05,-6,50.80875156097066
555,plated,16,4.4759626816611415e-05,10,6.750143440548111e-05,-6,50.80875156097066
556,assemblage,16,4.4759626816611415e-05,10,6.750143440548111e-05,-6,50.80875156097066
557,min,16,4.4759626816611415e-05,10,6.750143440548111e-05,-6,50.80875156097066
558,sealed,16,4.4759626816611415e-05,10,6.750143440548111e-05,-6,50.80875156097066
559,display,16,4.4759626816611415e-05,10,6.750143440548111e-05,-6,50.80875156097066
560,typescript,16,4.4759626816611415e-05,10,6.750143440548111e-05,-6,50.80875156097066
561,housing,15,4.19621501405732e-05,10,6.750143440548111e-05,-5,60.862668331702054
562,comic,15,4.19621501405732e-05,10,6.750143440548111e-05,-5,60.862668331702054
563,seed,15,4.19621501405732e-05,10,6.750143440548111e-05,-5,60.862668331702054
564,boxed,15,4.19621501405732e-05,10,6.750143440548111e-05,-5,60.862668331702054
565,altered,15,4.19621501405732e-05,10,6.750143440548111e-05,-5,60.862668331702054
566,karl,15,4.19621501405732e-05,10,6.750143440548111e-05,-5,60.862668331702054
567,glue,15,4.19621501405732e-05,10,6.750143440548111e-05,-5,60.862668331702054
568,board\r\n,15,4.19621501405732e-05,10,6.750143440548111e-05,-5,60.862668331702054
569,stick,15,4.19621501405732e-05,10,6.750143440548111e-05,-5,60.862668331702054
570,device,15,4.19621501405732e-05,10,6.750143440548111e-05,-5,60.862668331702054
571,egg,15,4.19621501405732e-05,10,6.750143440548111e-05,-5,60.862668331702054
572,copies,15,4.19621501405732e-05,10,6.750143440548111e-05,-5,60.862668331702054
573,attaché,15,4.19621501405732e-05,9,6.0751290964933e-05,-6,44.77640149853185
574,limestone,15,4.19621501405732e-05,9,6.0751290964933e-05,-6,44.77640149853185
575,zipatone,15,4.19621501405732e-05,9,6.0751290964933e-05,-6,44.77640149853185
576,soot,15,4.19621501405732e-05,9,6.0751290964933e-05,-6,44.77640149853185
577,cyanotype,15,4.19621501405732e-05,9,6.0751290964933e-05,-6,44.77640149853185
578,print\r\n,15,4.19621501405732e-05,9,6.0751290964933e-05,-6,44.77640149853185
579,stand,15,4.19621501405732e-05,9,6.0751290964933e-05,-6,44.77640149853185
580,taped,14,3.916467346453499e-05,9,6.0751290964933e-05,-5,55.117573034141266
581,edition,14,3.916467346453499e-05,9,6.0751290964933e-05,-5,55.117573034141266
582,bakelite,14,3.916467346453499e-05,9,6.0751290964933e-05,-5,55.117573034141266
583,horsehair,14,3.916467346453499e-05,9,6.0751290964933e-05,-5,55.117573034141266
584,styrene,14,3.916467346453499e-05,9,6.0751290964933e-05,-5,55.117573034141266
585,monograph,14,3.916467346453499e-05,9,6.0751290964933e-05,-5,55.117573034141266
586,dried,14,3.916467346453499e-05,9,6.0751290964933e-05,-5,55.117573034141266
587,incising,14,3.916467346453499e-05,9,6.0751290964933e-05,-5,55.117573034141266
588,unglazed,14,3.916467346453499e-05,9,6.0751290964933e-05,-5,55.117573034141266
589,recording,14,3.916467346453499e-05,9,6.0751290964933e-05,-5,55.117573034141266
590,onesheet,14,3.916467346453499e-05,9,6.0751290964933e-05,-5,55.117573034141266
591,enamelled,14,3.916467346453499e-05,9,6.0751290964933e-05,-5,55.117573034141266
592,inserted,14,3.916467346453499e-05,9,6.0751290964933e-05,-5,55.117573034141266
593,repeated,14,3.916467346453499e-05,9,6.0751290964933e-05,-5,55.117573034141266
594,pvc,14,3.916467346453499e-05,9,6.0751290964933e-05,-5,55.117573034141266
595,leaves,14,3.916467346453499e-05,9,6.0751290964933e-05,-5,55.117573034141266
596,sections,14,3.916467346453499e-05,9,6.0751290964933e-05,-5,55.117573034141266
597,handapplied,14,3.916467346453499e-05,9,6.0751290964933e-05,-5,55.117573034141266
598,handmade,14,3.916467346453499e-05,9,6.0751290964933e-05,-5,55.117573034141266
599,button,13,3.636719678849678e-05,9,6.0751290964933e-05,-4,67.04969403676749
600,jar,13,3.636719678849678e-05,9,6.0751290964933e-05,-4,67.04969403676749
601,textile,13,3.636719678849678e-05,9,6.0751290964933e-05,-4,67.04969403676749
602,cotta,13,3.636719678849678e-05,9,6.0751290964933e-05,-4,67.04969403676749
603,bone,13,3.636719678849678e-05,9,6.0751290964933e-05,-4,67.04969403676749
604,terra,13,3.636719678849678e-05,9,6.0751290964933e-05,-4,67.04969403676749
605,felixmüller,13,3.636719678849678e-05,9,6.0751290964933e-05,-4,67.04969403676749
606,japanese,13,3.636719678849678e-05,9,6.0751290964933e-05,-4,67.04969403676749
607,softground,13,3.636719678849678e-05,9,6.0751290964933e-05,-4,67.04969403676749
608,polypropylene,13,3.636719678849678e-05,9,6.0751290964933e-05,-4,67.04969403676749
609,chenille,13,3.636719678849678e-05,9,6.0751290964933e-05,-4,67.04969403676749
610,rattan,13,3.636719678849678e-05,8,5.400114752438489e-05,-5,48.48861692157111
611,program,13,3.636719678849678e-05,8,5.400114752438489e-05,-5,48.48861692157111
612,fish,13,3.636719678849678e-05,8,5.400114752438489e-05,-5,48.48861692157111
613,cutandfolded,13,3.636719678849678e-05,8,5.400114752438489e-05,-5,48.48861692157111
614,0inch,13,3.636719678849678e-05,8,5.400114752438489e-05,-5,48.48861692157111
615,chocolate,13,3.636719678849678e-05,8,5.400114752438489e-05,-5,48.48861692157111
616,ebony,13,3.636719678849678e-05,8,5.400114752438489e-05,-5,48.48861692157111
617,silverplated,13,3.636719678849678e-05,8,5.400114752438489e-05,-5,48.48861692157111
618,playing,13,3.636719678849678e-05,8,5.400114752438489e-05,-5,48.48861692157111
619,water,13,3.636719678849678e-05,8,5.400114752438489e-05,-5,48.48861692157111
620,dvd,13,3.636719678849678e-05,8,5.400114752438489e-05,-5,48.48861692157111
621,conrad,13,3.636719678849678e-05,8,5.400114752438489e-05,-5,48.48861692157111
622,handblown,13,3.636719678849678e-05,8,5.400114752438489e-05,-5,48.48861692157111
623,napkin,12,3.3569720112458565e-05,8,5.400114752438489e-05,-4,60.86266833170204
624,tipped,12,3.3569720112458565e-05,8,5.400114752438489e-05,-4,60.86266833170204
625,chloride,12,3.3569720112458565e-05,8,5.400114752438489e-05,-4,60.86266833170204
626,parchment,12,3.3569720112458565e-05,8,5.400114752438489e-05,-4,60.86266833170204
627,key,12,3.3569720112458565e-05,8,5.400114752438489e-05,-4,60.86266833170204
628,mount,12,3.3569720112458565e-05,8,5.400114752438489e-05,-4,60.86266833170204
629,grey,12,3.3569720112458565e-05,8,5.400114752438489e-05,-4,60.86266833170204
630,powdered,12,3.3569720112458565e-05,8,5.400114752438489e-05,-4,60.86266833170204
631,solarized,12,3.3569720112458565e-05,8,5.400114752438489e-05,-4,60.86266833170204
632,vitreous,12,3.3569720112458565e-05,8,5.400114752438489e-05,-4,60.86266833170204
633,dark,12,3.3569720112458565e-05,8,5.400114752438489e-05,-4,60.86266833170204
634,fluorescent,12,3.3569720112458565e-05,8,5.400114752438489e-05,-4,60.86266833170204
635,empty,12,3.3569720112458565e-05,8,5.400114752438489e-05,-4,60.86266833170204
636,die,12,3.3569720112458565e-05,8,5.400114752438489e-05,-4,60.86266833170204
637,pencil\r\n,12,3.3569720112458565e-05,8,5.400114752438489e-05,-4,60.86266833170204
638,de,12,3.3569720112458565e-05,8,5.400114752438489e-05,-4,60.86266833170204
639,phenolic,11,3.077224343642035e-05,8,5.400114752438489e-05,-3,75.48654727094768
640,printing,11,3.077224343642035e-05,8,5.400114752438489e-05,-3,75.48654727094768
641,dot,11,3.077224343642035e-05,8,5.400114752438489e-05,-3,75.48654727094768
642,slate,11,3.077224343642035e-05,8,5.400114752438489e-05,-3,75.48654727094768
643,jacket,11,3.077224343642035e-05,8,5.400114752438489e-05,-3,75.48654727094768
644,electronic,11,3.077224343642035e-05,8,5.400114752438489e-05,-3,75.48654727094768
645,prepared,11,3.077224343642035e-05,8,5.400114752438489e-05,-3,75.48654727094768
646,chair,11,3.077224343642035e-05,8,5.400114752438489e-05,-3,75.48654727094768
647,hair,11,3.077224343642035e-05,8,5.400114752438489e-05,-3,75.48654727094768
648,cement,11,3.077224343642035e-05,8,5.400114752438489e-05,-3,75.48654727094768
649,certificate,11,3.077224343642035e-05,8,5.400114752438489e-05,-3,75.48654727094768
650,satin,11,3.077224343642035e-05,7,4.725100408383678e-05,-4,53.550728862079225
651,ash,11,3.077224343642035e-05,7,4.725100408383678e-05,-4,53.550728862079225
652,velvet,11,3.077224343642035e-05,7,4.725100408383678e-05,-4,53.550728862079225
653,telephone,11,3.077224343642035e-05,7,4.725100408383678e-05,-4,53.550728862079225
654,half,11,3.077224343642035e-05,7,4.725100408383678e-05,-4,53.550728862079225
655,flexidisc,11,3.077224343642035e-05,7,4.725100408383678e-05,-4,53.550728862079225
656,double,11,3.077224343642035e-05,7,4.725100408383678e-05,-4,53.550728862079225
657,ii,11,3.077224343642035e-05,7,4.725100408383678e-05,-4,53.550728862079225
658,units,11,3.077224343642035e-05,7,4.725100408383678e-05,-4,53.550728862079225
659,tinted,10,2.7974766760382136e-05,7,4.725100408383678e-05,-3,68.90580174828716
660,reinforced,10,2.7974766760382136e-05,7,4.725100408383678e-05,-3,68.90580174828716
661,pedestal,10,2.7974766760382136e-05,7,4.725100408383678e-05,-3,68.90580174828716
662,glove,10,2.7974766760382136e-05,7,4.725100408383678e-05,-3,68.90580174828716
663,working,10,2.7974766760382136e-05,7,4.725100408383678e-05,-3,68.90580174828716
664,cherry,10,2.7974766760382136e-05,7,4.725100408383678e-05,-3,68.90580174828716
665,stretch,10,2.7974766760382136e-05,7,4.725100408383678e-05,-3,68.90580174828716
666,formica,10,2.7974766760382136e-05,7,4.725100408383678e-05,-3,68.90580174828716
667,chromiumplated,10,2.7974766760382136e-05,7,4.725100408383678e-05,-3,68.90580174828716
668,maple,10,2.7974766760382136e-05,7,4.725100408383678e-05,-3,68.90580174828716
669,cellulose,10,2.7974766760382136e-05,7,4.725100408383678e-05,-3,68.90580174828716
670,adhered,10,2.7974766760382136e-05,7,4.725100408383678e-05,-3,68.90580174828716
671,pine,10,2.7974766760382136e-05,7,4.725100408383678e-05,-3,68.90580174828716
672,language,10,2.7974766760382136e-05,7,4.725100408383678e-05,-3,68.90580174828716
673,referred,10,2.7974766760382136e-05,7,4.725100408383678e-05,-3,68.90580174828716
674,additions\r\n,10,2.7974766760382136e-05,7,4.725100408383678e-05,-3,68.90580174828716
675,masonite,10,2.7974766760382136e-05,7,4.725100408383678e-05,-3,68.90580174828716
676,styrofoam,10,2.7974766760382136e-05,7,4.725100408383678e-05,-3,68.90580174828716
677,weight,10,2.7974766760382136e-05,7,4.725100408383678e-05,-3,68.90580174828716
678,solid,10,2.7974766760382136e-05,7,4.725100408383678e-05,-3,68.90580174828716
679,beeswax,10,2.7974766760382136e-05,7,4.725100408383678e-05,-3,68.90580174828716
680,cube,10,2.7974766760382136e-05,7,4.725100408383678e-05,-3,68.90580174828716
681,hundred,10,2.7974766760382136e-05,7,4.725100408383678e-05,-3,68.90580174828716
682,jacob,10,2.7974766760382136e-05,7,4.725100408383678e-05,-3,68.90580174828716
683,photocollage,10,2.7974766760382136e-05,7,4.725100408383678e-05,-3,68.90580174828716
684,encaustic,10,2.7974766760382136e-05,7,4.725100408383678e-05,-3,68.90580174828716
685,sterling,10,2.7974766760382136e-05,7,4.725100408383678e-05,-3,68.90580174828716
686,theater,10,2.7974766760382136e-05,7,4.725100408383678e-05,-3,68.90580174828716
687,hirsch,9,2.517729008434392e-05,7,4.725100408383678e-05,-2,87.67311305365241
688,natural,9,2.517729008434392e-05,7,4.725100408383678e-05,-2,87.67311305365241
689,inked,9,2.517729008434392e-05,7,4.725100408383678e-05,-2,87.67311305365241
690,balsa,9,2.517729008434392e-05,7,4.725100408383678e-05,-2,87.67311305365241
691,marcel,9,2.517729008434392e-05,7,4.725100408383678e-05,-2,87.67311305365241
692,wraparound,9,2.517729008434392e-05,7,4.725100408383678e-05,-2,87.67311305365241
693,woodcuts\r\n,9,2.517729008434392e-05,7,4.725100408383678e-05,-2,87.67311305365241
694,galvanized,9,2.517729008434392e-05,7,4.725100408383678e-05,-2,87.67311305365241
695,laminate,9,2.517729008434392e-05,7,4.725100408383678e-05,-2,87.67311305365241
696,david,9,2.517729008434392e-05,7,4.725100408383678e-05,-2,87.67311305365241
697,bamboo,9,2.517729008434392e-05,7,4.725100408383678e-05,-2,87.67311305365241
698,projector,9,2.517729008434392e-05,6,4.050086064328867e-05,-3,60.86266833170208
699,gilded,9,2.517729008434392e-05,6,4.050086064328867e-05,-3,60.86266833170208
700,projection,9,2.517729008434392e-05,6,4.050086064328867e-05,-3,60.86266833170208
701,filled,9,2.517729008434392e-05,6,4.050086064328867e-05,-3,60.86266833170208
702,binder,9,2.517729008434392e-05,6,4.050086064328867e-05,-3,60.86266833170208
703,toy,9,2.517729008434392e-05,6,4.050086064328867e-05,-3,60.86266833170208
704,burnt,9,2.517729008434392e-05,6,4.050086064328867e-05,-3,60.86266833170208
705,point,9,2.517729008434392e-05,6,4.050086064328867e-05,-3,60.86266833170208
706,dyed,9,2.517729008434392e-05,6,4.050086064328867e-05,-3,60.86266833170208
707,components,9,2.517729008434392e-05,6,4.050086064328867e-05,-3,60.86266833170208
708,tornandpasted,9,2.517729008434392e-05,6,4.050086064328867e-05,-3,60.86266833170208
709,lp,9,2.517729008434392e-05,6,4.050086064328867e-05,-3,60.86266833170208
710,hardware,9,2.517729008434392e-05,6,4.050086064328867e-05,-3,60.86266833170208
711,translucent,9,2.517729008434392e-05,6,4.050086064328867e-05,-3,60.86266833170208
712,pearl,9,2.517729008434392e-05,6,4.050086064328867e-05,-3,60.86266833170208
713,matches,9,2.517729008434392e-05,6,4.050086064328867e-05,-3,60.86266833170208
714,heatresistant,9,2.517729008434392e-05,6,4.050086064328867e-05,-3,60.86266833170208
715,reliefprinted,9,2.517729008434392e-05,6,4.050086064328867e-05,-3,60.86266833170208
716,paste,9,2.517729008434392e-05,6,4.050086064328867e-05,-3,60.86266833170208
717,baked,9,2.517729008434392e-05,6,4.050086064328867e-05,-3,60.86266833170208
718,ping,8,2.2379813408305708e-05,6,4.050086064328867e-05,-2,80.97050187316482
719,foamcore,8,2.2379813408305708e-05,6,4.050086064328867e-05,-2,80.97050187316482
720,varnished,8,2.2379813408305708e-05,6,4.050086064328867e-05,-2,80.97050187316482
721,rives,8,2.2379813408305708e-05,6,4.050086064328867e-05,-2,80.97050187316482
722,ribbon,8,2.2379813408305708e-05,6,4.050086064328867e-05,-2,80.97050187316482
723,letterpress\r\n,8,2.2379813408305708e-05,6,4.050086064328867e-05,-2,80.97050187316482
724,padding,8,2.2379813408305708e-05,6,4.050086064328867e-05,-2,80.97050187316482
725,liquid,8,2.2379813408305708e-05,6,4.050086064328867e-05,-2,80.97050187316482
726,epoxy,8,2.2379813408305708e-05,6,4.050086064328867e-05,-2,80.97050187316482
727,hinged,8,2.2379813408305708e-05,6,4.050086064328867e-05,-2,80.97050187316482
728,direct,8,2.2379813408305708e-05,6,4.050086064328867e-05,-2,80.97050187316482
729,postage,8,2.2379813408305708e-05,6,4.050086064328867e-05,-2,80.97050187316482
730,pong,8,2.2379813408305708e-05,6,4.050086064328867e-05,-2,80.97050187316482
731,special,8,2.2379813408305708e-05,6,4.050086064328867e-05,-2,80.97050187316482
732,bottom,8,2.2379813408305708e-05,6,4.050086064328867e-05,-2,80.97050187316482
733,handwoven,8,2.2379813408305708e-05,6,4.050086064328867e-05,-2,80.97050187316482
734,transparent,8,2.2379813408305708e-05,6,4.050086064328867e-05,-2,80.97050187316482
735,foldout,8,2.2379813408305708e-05,6,4.050086064328867e-05,-2,80.97050187316482
736,pink,8,2.2379813408305708e-05,6,4.050086064328867e-05,-2,80.97050187316482
737,packets,8,2.2379813408305708e-05,6,4.050086064328867e-05,-2,80.97050187316482
738,composite,8,2.2379813408305708e-05,6,4.050086064328867e-05,-2,80.97050187316482
739,architectural,8,2.2379813408305708e-05,6,4.050086064328867e-05,-2,80.97050187316482
740,silicon,8,2.2379813408305708e-05,6,4.050086064328867e-05,-2,80.97050187316482
741,paper\r\nc,8,2.2379813408305708e-05,6,4.050086064328867e-05,-2,80.97050187316482
742,numerous,8,2.2379813408305708e-05,6,4.050086064328867e-05,-2,80.97050187316482
743,puzzle,8,2.2379813408305708e-05,6,4.050086064328867e-05,-2,80.97050187316482
744,ring,8,2.2379813408305708e-05,6,4.050086064328867e-05,-2,80.97050187316482
745,orange,8,2.2379813408305708e-05,6,4.050086064328867e-05,-2,80.97050187316482
746,index,8,2.2379813408305708e-05,6,4.050086064328867e-05,-2,80.97050187316482
747,mark,8,2.2379813408305708e-05,6,4.050086064328867e-05,-2,80.97050187316482
748,bars,8,2.2379813408305708e-05,6,4.050086064328867e-05,-2,80.97050187316482
749,armature,8,2.2379813408305708e-05,6,4.050086064328867e-05,-2,80.97050187316482
750,castiron,8,2.2379813408305708e-05,6,4.050086064328867e-05,-2,80.97050187316482
751,extruded,8,2.2379813408305708e-05,6,4.050086064328867e-05,-2,80.97050187316482
752,flash,8,2.2379813408305708e-05,6,4.050086064328867e-05,-2,80.97050187316482
753,screws,8,2.2379813408305708e-05,6,4.050086064328867e-05,-2,80.97050187316482
754,plasticcoated,8,2.2379813408305708e-05,6,4.050086064328867e-05,-2,80.97050187316482
755,oilstick,8,2.2379813408305708e-05,6,4.050086064328867e-05,-2,80.97050187316482
756,automobile,8,2.2379813408305708e-05,6,4.050086064328867e-05,-2,80.97050187316482
757,commercially,8,2.2379813408305708e-05,6,4.050086064328867e-05,-2,80.97050187316482
758,plant,8,2.2379813408305708e-05,6,4.050086064328867e-05,-2,80.97050187316482
759,putty,8,2.2379813408305708e-05,6,4.050086064328867e-05,-2,80.97050187316482
760,loop,8,2.2379813408305708e-05,6,4.050086064328867e-05,-2,80.97050187316482
761,accordion,8,2.2379813408305708e-05,6,4.050086064328867e-05,-2,80.97050187316482
762,yarn,8,2.2379813408305708e-05,6,4.050086064328867e-05,-2,80.97050187316482
763,adhesive,8,2.2379813408305708e-05,6,4.050086064328867e-05,-2,80.97050187316482
764,ephemera,8,2.2379813408305708e-05,5,3.375071720274056e-05,-3,50.8087515609707
765,gessoed,8,2.2379813408305708e-05,5,3.375071720274056e-05,-3,50.8087515609707
766,cable,8,2.2379813408305708e-05,5,3.375071720274056e-05,-3,50.8087515609707
767,press,8,2.2379813408305708e-05,5,3.375071720274056e-05,-3,50.8087515609707
768,spit,8,2.2379813408305708e-05,5,3.375071720274056e-05,-3,50.8087515609707
769,reprint,8,2.2379813408305708e-05,5,3.375071720274056e-05,-3,50.8087515609707
770,attached,8,2.2379813408305708e-05,5,3.375071720274056e-05,-3,50.8087515609707
771,german,7,1.9582336732267493e-05,5,3.375071720274056e-05,-2,72.35285892682366
772,sx0,7,1.9582336732267493e-05,5,3.375071720274056e-05,-2,72.35285892682366
773,wrapping,7,1.9582336732267493e-05,5,3.375071720274056e-05,-2,72.35285892682366
774,probably,7,1.9582336732267493e-05,5,3.375071720274056e-05,-2,72.35285892682366
775,unidentified,7,1.9582336732267493e-05,5,3.375071720274056e-05,-2,72.35285892682366
776,aquatint\r\n,7,1.9582336732267493e-05,5,3.375071720274056e-05,-2,72.35285892682366
777,mercerized,7,1.9582336732267493e-05,5,3.375071720274056e-05,-2,72.35285892682366
778,georg,7,1.9582336732267493e-05,5,3.375071720274056e-05,-2,72.35285892682366
779,broken,7,1.9582336732267493e-05,5,3.375071720274056e-05,-2,72.35285892682366
780,shaped,7,1.9582336732267493e-05,5,3.375071720274056e-05,-2,72.35285892682366
781,emulsion,7,1.9582336732267493e-05,5,3.375071720274056e-05,-2,72.35285892682366
782,clock,7,1.9582336732267493e-05,5,3.375071720274056e-05,-2,72.35285892682366
783,fur,7,1.9582336732267493e-05,5,3.375071720274056e-05,-2,72.35285892682366
784,brushed,7,1.9582336732267493e-05,5,3.375071720274056e-05,-2,72.35285892682366
785,presentation,7,1.9582336732267493e-05,5,3.375071720274056e-05,-2,72.35285892682366
786,game,7,1.9582336732267493e-05,5,3.375071720274056e-05,-2,72.35285892682366
787,beans,7,1.9582336732267493e-05,5,3.375071720274056e-05,-2,72.35285892682366
788,hotel,7,1.9582336732267493e-05,5,3.375071720274056e-05,-2,72.35285892682366
789,hemp,7,1.9582336732267493e-05,5,3.375071720274056e-05,-2,72.35285892682366
790,e,7,1.9582336732267493e-05,5,3.375071720274056e-05,-2,72.35285892682366
791,sepiatoned,7,1.9582336732267493e-05,5,3.375071720274056e-05,-2,72.35285892682366
792,joined,7,1.9582336732267493e-05,5,3.375071720274056e-05,-2,72.35285892682366
793,canvases,7,1.9582336732267493e-05,5,3.375071720274056e-05,-2,72.35285892682366
794,clay,7,1.9582336732267493e-05,5,3.375071720274056e-05,-2,72.35285892682366
795,epoxycoated,7,1.9582336732267493e-05,5,3.375071720274056e-05,-2,72.35285892682366
796,camera,7,1.9582336732267493e-05,5,3.375071720274056e-05,-2,72.35285892682366
797,hard,7,1.9582336732267493e-05,5,3.375071720274056e-05,-2,72.35285892682366
798,name,7,1.9582336732267493e-05,5,3.375071720274056e-05,-2,72.35285892682366
799,padded,7,1.9582336732267493e-05,5,3.375071720274056e-05,-2,72.35285892682366
800,french,7,1.9582336732267493e-05,5,3.375071720274056e-05,-2,72.35285892682366
801,flocked,7,1.9582336732267493e-05,5,3.375071720274056e-05,-2,72.35285892682366
802,museum,7,1.9582336732267493e-05,5,3.375071720274056e-05,-2,72.35285892682366
803,shopping,7,1.9582336732267493e-05,5,3.375071720274056e-05,-2,72.35285892682366
804,sprayed,7,1.9582336732267493e-05,5,3.375071720274056e-05,-2,72.35285892682366
805,new,7,1.9582336732267493e-05,5,3.375071720274056e-05,-2,72.35285892682366
806,hinges,7,1.9582336732267493e-05,5,3.375071720274056e-05,-2,72.35285892682366
807,grommets,7,1.9582336732267493e-05,5,3.375071720274056e-05,-2,72.35285892682366
808,spun,7,1.9582336732267493e-05,5,3.375071720274056e-05,-2,72.35285892682366
809,mat,7,1.9582336732267493e-05,5,3.375071720274056e-05,-2,72.35285892682366
810,plus,7,1.9582336732267493e-05,5,3.375071720274056e-05,-2,72.35285892682366
811,waxed,7,1.9582336732267493e-05,5,3.375071720274056e-05,-2,72.35285892682366
812,richard,7,1.9582336732267493e-05,5,3.375071720274056e-05,-2,72.35285892682366
813,pamphlet,7,1.9582336732267493e-05,5,3.375071720274056e-05,-2,72.35285892682366
814,crumpled,7,1.9582336732267493e-05,5,3.375071720274056e-05,-2,72.35285892682366
815,coating,7,1.9582336732267493e-05,5,3.375071720274056e-05,-2,72.35285892682366
816,elastic,7,1.9582336732267493e-05,5,3.375071720274056e-05,-2,72.35285892682366
817,neon,7,1.9582336732267493e-05,5,3.375071720274056e-05,-2,72.35285892682366
818,loose,7,1.9582336732267493e-05,5,3.375071720274056e-05,-2,72.35285892682366
819,bfk,7,1.9582336732267493e-05,5,3.375071720274056e-05,-2,72.35285892682366
820,blank,7,1.9582336732267493e-05,5,3.375071720274056e-05,-2,72.35285892682366
821,tan,7,1.9582336732267493e-05,5,3.375071720274056e-05,-2,72.35285892682366
822,elements,7,1.9582336732267493e-05,5,3.375071720274056e-05,-2,72.35285892682366
823,capsules,6,1.6784860056229282e-05,5,3.375071720274056e-05,-1,101.07833541462759
824,portrait,6,1.6784860056229282e-05,5,3.375071720274056e-05,-1,101.07833541462759
825,inset,6,1.6784860056229282e-05,5,3.375071720274056e-05,-1,101.07833541462759
826,rice,6,1.6784860056229282e-05,5,3.375071720274056e-05,-1,101.07833541462759
827,published,6,1.6784860056229282e-05,5,3.375071720274056e-05,-1,101.07833541462759
828,milk,6,1.6784860056229282e-05,5,3.375071720274056e-05,-1,101.07833541462759
829,j,6,1.6784860056229282e-05,5,3.375071720274056e-05,-1,101.07833541462759
830,wiping,6,1.6784860056229282e-05,5,3.375071720274056e-05,-1,101.07833541462759
831,sides,6,1.6784860056229282e-05,5,3.375071720274056e-05,-1,101.07833541462759
832,paper\r\nd,6,1.6784860056229282e-05,5,3.375071720274056e-05,-1,101.07833541462759
833,unstretched,6,1.6784860056229282e-05,5,3.375071720274056e-05,-1,101.07833541462759
834,collograph,6,1.6784860056229282e-05,5,3.375071720274056e-05,-1,101.07833541462759
835,partially,6,1.6784860056229282e-05,5,3.375071720274056e-05,-1,101.07833541462759
836,tacks,6,1.6784860056229282e-05,5,3.375071720274056e-05,-1,101.07833541462759
837,tiles,6,1.6784860056229282e-05,5,3.375071720274056e-05,-1,101.07833541462759
838,fixtures,6,1.6784860056229282e-05,5,3.375071720274056e-05,-1,101.07833541462759
839,tip,6,1.6784860056229282e-05,5,3.375071720274056e-05,-1,101.07833541462759
840,wilhelm,6,1.6784860056229282e-05,5,3.375071720274056e-05,-1,101.07833541462759
841,paris,6,1.6784860056229282e-05,5,3.375071720274056e-05,-1,101.07833541462759
842,polycarbonate,6,1.6784860056229282e-05,5,3.375071720274056e-05,-1,101.07833541462759
843,positive,6,1.6784860056229282e-05,5,3.375071720274056e-05,-1,101.07833541462759
844,stationery,6,1.6784860056229282e-05,5,3.375071720274056e-05,-1,101.07833541462759
845,injectionmolded,6,1.6784860056229282e-05,5,3.375071720274056e-05,-1,101.07833541462759
846,gunpowder,6,1.6784860056229282e-05,5,3.375071720274056e-05,-1,101.07833541462759
847,papiermâché,6,1.6784860056229282e-05,5,3.375071720274056e-05,-1,101.07833541462759
848,gauze,6,1.6784860056229282e-05,4,2.7000573762192447e-05,-2,60.86266833170204
849,numbers,6,1.6784860056229282e-05,4,2.7000573762192447e-05,-2,60.86266833170204
850,floor,6,1.6784860056229282e-05,4,2.7000573762192447e-05,-2,60.86266833170204
851,electrical,6,1.6784860056229282e-05,4,2.7000573762192447e-05,-2,60.86266833170204
852,chipboard,6,1.6784860056229282e-05,4,2.7000573762192447e-05,-2,60.86266833170204
853,viewer,6,1.6784860056229282e-05,4,2.7000573762192447e-05,-2,60.86266833170204
854,perspex,6,1.6784860056229282e-05,4,2.7000573762192447e-05,-2,60.86266833170204
855,tappert,6,1.6784860056229282e-05,4,2.7000573762192447e-05,-2,60.86266833170204
856,right,6,1.6784860056229282e-05,4,2.7000573762192447e-05,-2,60.86266833170204
857,l,6,1.6784860056229282e-05,4,2.7000573762192447e-05,-2,60.86266833170204
858,pebbles,6,1.6784860056229282e-05,4,2.7000573762192447e-05,-2,60.86266833170204
859,basalt,6,1.6784860056229282e-05,4,2.7000573762192447e-05,-2,60.86266833170204
860,spiralbound,6,1.6784860056229282e-05,4,2.7000573762192447e-05,-2,60.86266833170204
861,polyvinyl,6,1.6784860056229282e-05,4,2.7000573762192447e-05,-2,60.86266833170204
862,paper\r\n\r\n,6,1.6784860056229282e-05,4,2.7000573762192447e-05,-2,60.86266833170204
863,grease,6,1.6784860056229282e-05,4,2.7000573762192447e-05,-2,60.86266833170204
864,body,6,1.6784860056229282e-05,4,2.7000573762192447e-05,-2,60.86266833170204
865,violin,6,1.6784860056229282e-05,4,2.7000573762192447e-05,-2,60.86266833170204
866,erich,6,1.6784860056229282e-05,4,2.7000573762192447e-05,-2,60.86266833170204
867,spine,5,1.3987383380191068e-05,4,2.7000573762192447e-05,-1,93.03520199804245
868,rolled,5,1.3987383380191068e-05,4,2.7000573762192447e-05,-1,93.03520199804245
869,disc,5,1.3987383380191068e-05,4,2.7000573762192447e-05,-1,93.03520199804245
870,instructions,5,1.3987383380191068e-05,4,2.7000573762192447e-05,-1,93.03520199804245
871,pill,5,1.3987383380191068e-05,4,2.7000573762192447e-05,-1,93.03520199804245
872,left,5,1.3987383380191068e-05,4,2.7000573762192447e-05,-1,93.03520199804245
873,diptych,5,1.3987383380191068e-05,4,2.7000573762192447e-05,-1,93.03520199804245
874,cigarette,5,1.3987383380191068e-05,4,2.7000573762192447e-05,-1,93.03520199804245
875,lightbulbs,5,1.3987383380191068e-05,4,2.7000573762192447e-05,-1,93.03520199804245
876,page\r\n,5,1.3987383380191068e-05,4,2.7000573762192447e-05,-1,93.03520199804245
877,sugar,5,1.3987383380191068e-05,4,2.7000573762192447e-05,-1,93.03520199804245
878,logo,5,1.3987383380191068e-05,4,2.7000573762192447e-05,-1,93.03520199804245
879,watch,5,1.3987383380191068e-05,4,2.7000573762192447e-05,-1,93.03520199804245
880,eyes,5,1.3987383380191068e-05,4,2.7000573762192447e-05,-1,93.03520199804245
881,miniature,5,1.3987383380191068e-05,4,2.7000573762192447e-05,-1,93.03520199804245
882,razor,5,1.3987383380191068e-05,4,2.7000573762192447e-05,-1,93.03520199804245
883,towel,5,1.3987383380191068e-05,4,2.7000573762192447e-05,-1,93.03520199804245
884,solander,5,1.3987383380191068e-05,4,2.7000573762192447e-05,-1,93.03520199804245
885,anger,5,1.3987383380191068e-05,4,2.7000573762192447e-05,-1,93.03520199804245
886,poem,5,1.3987383380191068e-05,4,2.7000573762192447e-05,-1,93.03520199804245
887,commercial,5,1.3987383380191068e-05,4,2.7000573762192447e-05,-1,93.03520199804245
888,folding,5,1.3987383380191068e-05,4,2.7000573762192447e-05,-1,93.03520199804245
889,rubbing,5,1.3987383380191068e-05,4,2.7000573762192447e-05,-1,93.03520199804245
890,blackboard,5,1.3987383380191068e-05,4,2.7000573762192447e-05,-1,93.03520199804245
891,clipped,5,1.3987383380191068e-05,4,2.7000573762192447e-05,-1,93.03520199804245
892,brochure,5,1.3987383380191068e-05,4,2.7000573762192447e-05,-1,93.03520199804245
893,layered,5,1.3987383380191068e-05,4,2.7000573762192447e-05,-1,93.03520199804245
894,used,5,1.3987383380191068e-05,4,2.7000573762192447e-05,-1,93.03520199804245
895,sack,5,1.3987383380191068e-05,4,2.7000573762192447e-05,-1,93.03520199804245
896,figures,5,1.3987383380191068e-05,4,2.7000573762192447e-05,-1,93.03520199804245
897,together,5,1.3987383380191068e-05,4,2.7000573762192447e-05,-1,93.03520199804245
898,figure,5,1.3987383380191068e-05,4,2.7000573762192447e-05,-1,93.03520199804245
899,hat,5,1.3987383380191068e-05,4,2.7000573762192447e-05,-1,93.03520199804245
900,spices,5,1.3987383380191068e-05,4,2.7000573762192447e-05,-1,93.03520199804245
901,see,5,1.3987383380191068e-05,4,2.7000573762192447e-05,-1,93.03520199804245
902,radio,5,1.3987383380191068e-05,4,2.7000573762192447e-05,-1,93.03520199804245
903,package,5,1.3987383380191068e-05,4,2.7000573762192447e-05,-1,93.03520199804245
904,flowers,5,1.3987383380191068e-05,4,2.7000573762192447e-05,-1,93.03520199804245
905,window,5,1.3987383380191068e-05,4,2.7000573762192447e-05,-1,93.03520199804245
906,stenciled,5,1.3987383380191068e-05,4,2.7000573762192447e-05,-1,93.03520199804245
907,medicine,5,1.3987383380191068e-05,4,2.7000573762192447e-05,-1,93.03520199804245
908,soap,5,1.3987383380191068e-05,4,2.7000573762192447e-05,-1,93.03520199804245
909,surface,5,1.3987383380191068e-05,4,2.7000573762192447e-05,-1,93.03520199804245
910,selective,5,1.3987383380191068e-05,4,2.7000573762192447e-05,-1,93.03520199804245
911,signed,5,1.3987383380191068e-05,4,2.7000573762192447e-05,-1,93.03520199804245
912,cylinder,5,1.3987383380191068e-05,4,2.7000573762192447e-05,-1,93.03520199804245
913,von,5,1.3987383380191068e-05,4,2.7000573762192447e-05,-1,93.03520199804245
914,screenprint\r\n,5,1.3987383380191068e-05,4,2.7000573762192447e-05,-1,93.03520199804245
915,schuler,5,1.3987383380191068e-05,4,2.7000573762192447e-05,-1,93.03520199804245
916,’,5,1.3987383380191068e-05,4,2.7000573762192447e-05,-1,93.03520199804245
917,match,5,1.3987383380191068e-05,4,2.7000573762192447e-05,-1,93.03520199804245
918,framed,5,1.3987383380191068e-05,4,2.7000573762192447e-05,-1,93.03520199804245
919,heinrich,5,1.3987383380191068e-05,4,2.7000573762192447e-05,-1,93.03520199804245
920,projected,5,1.3987383380191068e-05,4,2.7000573762192447e-05,-1,93.03520199804245
921,scorched,5,1.3987383380191068e-05,4,2.7000573762192447e-05,-1,93.03520199804245
922,seleniumtoned,5,1.3987383380191068e-05,4,2.7000573762192447e-05,-1,93.03520199804245
923,max,5,1.3987383380191068e-05,4,2.7000573762192447e-05,-1,93.03520199804245
924,dispenser,5,1.3987383380191068e-05,4,2.7000573762192447e-05,-1,93.03520199804245
925,shoe,5,1.3987383380191068e-05,4,2.7000573762192447e-05,-1,93.03520199804245
926,scored,5,1.3987383380191068e-05,4,2.7000573762192447e-05,-1,93.03520199804245
927,selenium,5,1.3987383380191068e-05,4,2.7000573762192447e-05,-1,93.03520199804245
928,straw,5,1.3987383380191068e-05,4,2.7000573762192447e-05,-1,93.03520199804245
929,basswood,5,1.3987383380191068e-05,4,2.7000573762192447e-05,-1,93.03520199804245
930,bowl,5,1.3987383380191068e-05,4,2.7000573762192447e-05,-1,93.03520199804245
931,tray,5,1.3987383380191068e-05,4,2.7000573762192447e-05,-1,93.03520199804245
932,cabinet,5,1.3987383380191068e-05,4,2.7000573762192447e-05,-1,93.03520199804245
933,switch,5,1.3987383380191068e-05,4,2.7000573762192447e-05,-1,93.03520199804245
934,carton,5,1.3987383380191068e-05,4,2.7000573762192447e-05,-1,93.03520199804245
935,speaker,5,1.3987383380191068e-05,4,2.7000573762192447e-05,-1,93.03520199804245
936,silvered,5,1.3987383380191068e-05,4,2.7000573762192447e-05,-1,93.03520199804245
937,samples,5,1.3987383380191068e-05,4,2.7000573762192447e-05,-1,93.03520199804245
938,strap,5,1.3987383380191068e-05,4,2.7000573762192447e-05,-1,93.03520199804245
939,paper\r\ne,5,1.3987383380191068e-05,4,2.7000573762192447e-05,-1,93.03520199804245
940,wheels,5,1.3987383380191068e-05,4,2.7000573762192447e-05,-1,93.03520199804245
941,modeling,5,1.3987383380191068e-05,4,2.7000573762192447e-05,-1,93.03520199804245
942,sign,5,1.3987383380191068e-05,4,2.7000573762192447e-05,-1,93.03520199804245
943,packing,5,1.3987383380191068e-05,4,2.7000573762192447e-05,-1,93.03520199804245
944,dat,5,1.3987383380191068e-05,4,2.7000573762192447e-05,-1,93.03520199804245
945,wheel,5,1.3987383380191068e-05,4,2.7000573762192447e-05,-1,93.03520199804245
946,neoprene,5,1.3987383380191068e-05,4,2.7000573762192447e-05,-1,93.03520199804245
947,sequins,5,1.3987383380191068e-05,4,2.7000573762192447e-05,-1,93.03520199804245
948,lens,4,1.1189906704152854e-05,4,2.7000573762192447e-05,0,141.2940024975531
949,blackandwhite,4,1.1189906704152854e-05,4,2.7000573762192447e-05,0,141.2940024975531
950,suspended,4,1.1189906704152854e-05,4,2.7000573762192447e-05,0,141.2940024975531
951,krapp,4,1.1189906704152854e-05,4,2.7000573762192447e-05,0,141.2940024975531
952,formed,4,1.1189906704152854e-05,4,2.7000573762192447e-05,0,141.2940024975531
953,straps,4,1.1189906704152854e-05,4,2.7000573762192447e-05,0,141.2940024975531
954,manipulated,4,1.1189906704152854e-05,3,2.0250430321644337e-05,-1,80.97050187316482
955,doll,4,1.1189906704152854e-05,3,2.0250430321644337e-05,-1,80.97050187316482
956,injected,4,1.1189906704152854e-05,3,2.0250430321644337e-05,-1,80.97050187316482
957,rubberized,4,1.1189906704152854e-05,3,2.0250430321644337e-05,-1,80.97050187316482
958,circuit,4,1.1189906704152854e-05,3,2.0250430321644337e-05,-1,80.97050187316482
959,tripod,4,1.1189906704152854e-05,3,2.0250430321644337e-05,-1,80.97050187316482
960,capek,4,1.1189906704152854e-05,3,2.0250430321644337e-05,-1,80.97050187316482
961,josef,4,1.1189906704152854e-05,3,2.0250430321644337e-05,-1,80.97050187316482
962,otto,4,1.1189906704152854e-05,3,2.0250430321644337e-05,-1,80.97050187316482
963,clothes,4,1.1189906704152854e-05,3,2.0250430321644337e-05,-1,80.97050187316482
964,dress,4,1.1189906704152854e-05,3,2.0250430321644337e-05,-1,80.97050187316482
965,usa,4,1.1189906704152854e-05,3,2.0250430321644337e-05,-1,80.97050187316482
966,viscose,4,1.1189906704152854e-05,3,2.0250430321644337e-05,-1,80.97050187316482
967,netting,4,1.1189906704152854e-05,3,2.0250430321644337e-05,-1,80.97050187316482
968,notations,4,1.1189906704152854e-05,3,2.0250430321644337e-05,-1,80.97050187316482
969,chain,4,1.1189906704152854e-05,3,2.0250430321644337e-05,-1,80.97050187316482
970,stamping,4,1.1189906704152854e-05,3,2.0250430321644337e-05,-1,80.97050187316482
971,rubberstamp,4,1.1189906704152854e-05,3,2.0250430321644337e-05,-1,80.97050187316482
972,paper\r\nf,4,1.1189906704152854e-05,3,2.0250430321644337e-05,-1,80.97050187316482
973,ink\r\n,4,1.1189906704152854e-05,3,2.0250430321644337e-05,-1,80.97050187316482
974,injection,4,1.1189906704152854e-05,3,2.0250430321644337e-05,-1,80.97050187316482
975,typewriter,4,1.1189906704152854e-05,3,2.0250430321644337e-05,-1,80.97050187316482
976,hanger,4,1.1189906704152854e-05,3,2.0250430321644337e-05,-1,80.97050187316482
977,cutandstapled,4,1.1189906704152854e-05,3,2.0250430321644337e-05,-1,80.97050187316482
978,stain,4,1.1189906704152854e-05,3,2.0250430321644337e-05,-1,80.97050187316482
979,magna,4,1.1189906704152854e-05,3,2.0250430321644337e-05,-1,80.97050187316482
980,oxide,4,1.1189906704152854e-05,3,2.0250430321644337e-05,-1,80.97050187316482
981,cibachrome,4,1.1189906704152854e-05,3,2.0250430321644337e-05,-1,80.97050187316482
982,nuts,4,1.1189906704152854e-05,3,2.0250430321644337e-05,-1,80.97050187316482
983,continuous,4,1.1189906704152854e-05,3,2.0250430321644337e-05,-1,80.97050187316482
984,monofilament,4,1.1189906704152854e-05,3,2.0250430321644337e-05,-1,80.97050187316482
985,microphone,4,1.1189906704152854e-05,3,2.0250430321644337e-05,-1,80.97050187316482
986,balloon,4,1.1189906704152854e-05,3,2.0250430321644337e-05,-1,80.97050187316482
987,van,4,1.1189906704152854e-05,3,2.0250430321644337e-05,-1,80.97050187316482
988,confirmation,4,1.1189906704152854e-05,3,2.0250430321644337e-05,-1,80.97050187316482
989,pin,4,1.1189906704152854e-05,3,2.0250430321644337e-05,-1,80.97050187316482
990,photoreproduction,4,1.1189906704152854e-05,3,2.0250430321644337e-05,-1,80.97050187316482
991,bell,4,1.1189906704152854e-05,3,2.0250430321644337e-05,-1,80.97050187316482
992,bulletin,4,1.1189906704152854e-05,3,2.0250430321644337e-05,-1,80.97050187316482
993,plaque,4,1.1189906704152854e-05,3,2.0250430321644337e-05,-1,80.97050187316482
994,piano,4,1.1189906704152854e-05,3,2.0250430321644337e-05,-1,80.97050187316482
995,silent\r\n,4,1.1189906704152854e-05,3,2.0250430321644337e-05,-1,80.97050187316482
996,lucite,4,1.1189906704152854e-05,3,2.0250430321644337e-05,-1,80.97050187316482
997,us,4,1.1189906704152854e-05,3,2.0250430321644337e-05,-1,80.97050187316482
998,sculptures,4,1.1189906704152854e-05,3,2.0250430321644337e-05,-1,80.97050187316482
999,burned,4,1.1189906704152854e-05,3,2.0250430321644337e-05,-1,80.97050187316482
1000,gehre,4,1.1189906704152854e-05,3,2.0250430321644337e-05,-1,80.97050187316482
1001,candy,4,1.1189906704152854e-05,3,2.0250430321644337e-05,-1,80.97050187316482
1002,india,4,1.1189906704152854e-05,3,2.0250430321644337e-05,-1,80.97050187316482
1003,times,4,1.1189906704152854e-05,3,2.0250430321644337e-05,-1,80.97050187316482
1004,cigar,4,1.1189906704152854e-05,3,2.0250430321644337e-05,-1,80.97050187316482
1005,sketchbook,4,1.1189906704152854e-05,3,2.0250430321644337e-05,-1,80.97050187316482
1006,substrate,4,1.1189906704152854e-05,3,2.0250430321644337e-05,-1,80.97050187316482
1007,needs,4,1.1189906704152854e-05,3,2.0250430321644337e-05,-1,80.97050187316482
1008,dowels,4,1.1189906704152854e-05,3,2.0250430321644337e-05,-1,80.97050187316482
1009,charred,4,1.1189906704152854e-05,3,2.0250430321644337e-05,-1,80.97050187316482
1010,announcement,4,1.1189906704152854e-05,3,2.0250430321644337e-05,-1,80.97050187316482
1011,bearings,4,1.1189906704152854e-05,3,2.0250430321644337e-05,-1,80.97050187316482
1012,squares,4,1.1189906704152854e-05,3,2.0250430321644337e-05,-1,80.97050187316482
1013,aluminized,4,1.1189906704152854e-05,3,2.0250430321644337e-05,-1,80.97050187316482
1014,transformer,4,1.1189906704152854e-05,3,2.0250430321644337e-05,-1,80.97050187316482
1015,typeface,4,1.1189906704152854e-05,3,2.0250430321644337e-05,-1,80.97050187316482
1016,full,4,1.1189906704152854e-05,3,2.0250430321644337e-05,-1,80.97050187316482
1017,earth,4,1.1189906704152854e-05,3,2.0250430321644337e-05,-1,80.97050187316482
1018,bill,4,1.1189906704152854e-05,3,2.0250430321644337e-05,-1,80.97050187316482
1019,velvetcovered,4,1.1189906704152854e-05,3,2.0250430321644337e-05,-1,80.97050187316482
1020,gimp,4,1.1189906704152854e-05,3,2.0250430321644337e-05,-1,80.97050187316482
1021,oxidized,4,1.1189906704152854e-05,3,2.0250430321644337e-05,-1,80.97050187316482
1022,library,4,1.1189906704152854e-05,3,2.0250430321644337e-05,-1,80.97050187316482
1023,food,4,1.1189906704152854e-05,3,2.0250430321644337e-05,-1,80.97050187316482
1024,rush,4,1.1189906704152854e-05,3,2.0250430321644337e-05,-1,80.97050187316482
1025,sugarlift,4,1.1189906704152854e-05,3,2.0250430321644337e-05,-1,80.97050187316482
1026,inside,4,1.1189906704152854e-05,3,2.0250430321644337e-05,-1,80.97050187316482
1027,laser,4,1.1189906704152854e-05,3,2.0250430321644337e-05,-1,80.97050187316482
1028,house,4,1.1189906704152854e-05,3,2.0250430321644337e-05,-1,80.97050187316482
1029,hole,4,1.1189906704152854e-05,3,2.0250430321644337e-05,-1,80.97050187316482
1030,housed,4,1.1189906704152854e-05,3,2.0250430321644337e-05,-1,80.97050187316482
1031,file,4,1.1189906704152854e-05,3,2.0250430321644337e-05,-1,80.97050187316482
1032,fragments,4,1.1189906704152854e-05,3,2.0250430321644337e-05,-1,80.97050187316482
1033,bark,4,1.1189906704152854e-05,3,2.0250430321644337e-05,-1,80.97050187316482
1034,uninked,4,1.1189906704152854e-05,3,2.0250430321644337e-05,-1,80.97050187316482
1035,primed,4,1.1189906704152854e-05,3,2.0250430321644337e-05,-1,80.97050187316482
1036,hook,4,1.1189906704152854e-05,3,2.0250430321644337e-05,-1,80.97050187316482
1037,english,4,1.1189906704152854e-05,3,2.0250430321644337e-05,-1,80.97050187316482
1038,castinjected,4,1.1189906704152854e-05,3,2.0250430321644337e-05,-1,80.97050187316482
1039,bruno,4,1.1189906704152854e-05,3,2.0250430321644337e-05,-1,80.97050187316482
1040,partly,4,1.1189906704152854e-05,3,2.0250430321644337e-05,-1,80.97050187316482
1041,purple,4,1.1189906704152854e-05,3,2.0250430321644337e-05,-1,80.97050187316482
1042,flat,4,1.1189906704152854e-05,3,2.0250430321644337e-05,-1,80.97050187316482
1043,fingerprint,4,1.1189906704152854e-05,3,2.0250430321644337e-05,-1,80.97050187316482
1044,adhesivebacked,4,1.1189906704152854e-05,3,2.0250430321644337e-05,-1,80.97050187316482
1045,magnets,4,1.1189906704152854e-05,3,2.0250430321644337e-05,-1,80.97050187316482
1046,complete,4,1.1189906704152854e-05,3,2.0250430321644337e-05,-1,80.97050187316482
1047,duration,4,1.1189906704152854e-05,3,2.0250430321644337e-05,-1,80.97050187316482
1048,blended,4,1.1189906704152854e-05,3,2.0250430321644337e-05,-1,80.97050187316482
1049,inking,4,1.1189906704152854e-05,3,2.0250430321644337e-05,-1,80.97050187316482
1050,flower,4,1.1189906704152854e-05,3,2.0250430321644337e-05,-1,80.97050187316482
1051,webbing,4,1.1189906704152854e-05,3,2.0250430321644337e-05,-1,80.97050187316482
1052,k,4,1.1189906704152854e-05,3,2.0250430321644337e-05,-1,80.97050187316482
1053,model,4,1.1189906704152854e-05,3,2.0250430321644337e-05,-1,80.97050187316482
1054,street,3,8.392430028114641e-06,3,2.0250430321644337e-05,0,141.2940024975531
1055,frosted,3,8.392430028114641e-06,3,2.0250430321644337e-05,0,141.2940024975531
1056,stuffed,3,8.392430028114641e-06,3,2.0250430321644337e-05,0,141.2940024975531
1057,pipe,3,8.392430028114641e-06,3,2.0250430321644337e-05,0,141.2940024975531
1058,artificial,3,8.392430028114641e-06,3,2.0250430321644337e-05,0,141.2940024975531
1059,dice,3,8.392430028114641e-06,3,2.0250430321644337e-05,0,141.2940024975531
1060,coins,3,8.392430028114641e-06,3,2.0250430321644337e-05,0,141.2940024975531
1061,definition,3,8.392430028114641e-06,3,2.0250430321644337e-05,0,141.2940024975531
1062,canister,3,8.392430028114641e-06,3,2.0250430321644337e-05,0,141.2940024975531
1063,pal,3,8.392430028114641e-06,3,2.0250430321644337e-05,0,141.2940024975531
1064,candle,3,8.392430028114641e-06,3,2.0250430321644337e-05,0,141.2940024975531
1065,installation,3,8.392430028114641e-06,3,2.0250430321644337e-05,0,141.2940024975531
1066,blood,3,8.392430028114641e-06,3,2.0250430321644337e-05,0,141.2940024975531
1067,shoes,3,8.392430028114641e-06,3,2.0250430321644337e-05,0,141.2940024975531
1068,pole,3,8.392430028114641e-06,3,2.0250430321644337e-05,0,141.2940024975531
1069,rug,3,8.392430028114641e-06,3,2.0250430321644337e-05,0,141.2940024975531
1070,polychromed,3,8.392430028114641e-06,3,2.0250430321644337e-05,0,141.2940024975531
1071,container,3,8.392430028114641e-06,3,2.0250430321644337e-05,0,141.2940024975531
1072,backed,3,8.392430028114641e-06,3,2.0250430321644337e-05,0,141.2940024975531
1073,glossy,3,8.392430028114641e-06,3,2.0250430321644337e-05,0,141.2940024975531
1074,feather,3,8.392430028114641e-06,3,2.0250430321644337e-05,0,141.2940024975531
1075,dish,3,8.392430028114641e-06,3,2.0250430321644337e-05,0,141.2940024975531
1076,confetti,3,8.392430028114641e-06,3,2.0250430321644337e-05,0,141.2940024975531
1077,manila,3,8.392430028114641e-06,3,2.0250430321644337e-05,0,141.2940024975531
1078,embossment,3,8.392430028114641e-06,2,1.3500286881096223e-05,-1,60.86266833170204
1079,needles,3,8.392430028114641e-06,2,1.3500286881096223e-05,-1,60.86266833170204
1080,bas,3,8.392430028114641e-06,2,1.3500286881096223e-05,-1,60.86266833170204
1081,batterypowered,3,8.392430028114641e-06,2,1.3500286881096223e-05,-1,60.86266833170204
1082,monitor,3,8.392430028114641e-06,2,1.3500286881096223e-05,-1,60.86266833170204
1083,coin,3,8.392430028114641e-06,2,1.3500286881096223e-05,-1,60.86266833170204
1084,stretched,3,8.392430028114641e-06,2,1.3500286881096223e-05,-1,60.86266833170204
1085,mailing,3,8.392430028114641e-06,2,1.3500286881096223e-05,-1,60.86266833170204
1086,packet,3,8.392430028114641e-06,2,1.3500286881096223e-05,-1,60.86266833170204
1087,goldplated,3,8.392430028114641e-06,2,1.3500286881096223e-05,-1,60.86266833170204
1088,contact,3,8.392430028114641e-06,2,1.3500286881096223e-05,-1,60.86266833170204
1089,animal,3,8.392430028114641e-06,2,1.3500286881096223e-05,-1,60.86266833170204
1090,player,3,8.392430028114641e-06,2,1.3500286881096223e-05,-1,60.86266833170204
1091,carpet,3,8.392430028114641e-06,2,1.3500286881096223e-05,-1,60.86266833170204
1092,patina,3,8.392430028114641e-06,2,1.3500286881096223e-05,-1,60.86266833170204
1093,kitakata,3,8.392430028114641e-06,2,1.3500286881096223e-05,-1,60.86266833170204
1094,kraft,3,8.392430028114641e-06,2,1.3500286881096223e-05,-1,60.86266833170204
1095,tile,3,8.392430028114641e-06,2,1.3500286881096223e-05,-1,60.86266833170204
1096,child,3,8.392430028114641e-06,2,1.3500286881096223e-05,-1,60.86266833170204
1097,fresco,3,8.392430028114641e-06,2,1.3500286881096223e-05,-1,60.86266833170204
1098,yet,3,8.392430028114641e-06,2,1.3500286881096223e-05,-1,60.86266833170204
1099,vivid,3,8.392430028114641e-06,2,1.3500286881096223e-05,-1,60.86266833170204
1100,pear,3,8.392430028114641e-06,2,1.3500286881096223e-05,-1,60.86266833170204
1101,fittings,3,8.392430028114641e-06,2,1.3500286881096223e-05,-1,60.86266833170204
1102,linseed,3,8.392430028114641e-06,2,1.3500286881096223e-05,-1,60.86266833170204
1103,particle,3,8.392430028114641e-06,2,1.3500286881096223e-05,-1,60.86266833170204
1104,buff,3,8.392430028114641e-06,2,1.3500286881096223e-05,-1,60.86266833170204
1105,brick,3,8.392430028114641e-06,2,1.3500286881096223e-05,-1,60.86266833170204
1106,polish,3,8.392430028114641e-06,2,1.3500286881096223e-05,-1,60.86266833170204
1107,photobooth,3,8.392430028114641e-06,2,1.3500286881096223e-05,-1,60.86266833170204
1108,tags,3,8.392430028114641e-06,2,1.3500286881096223e-05,-1,60.86266833170204
1109,coloring,3,8.392430028114641e-06,2,1.3500286881096223e-05,-1,60.86266833170204
1110,pan,3,8.392430028114641e-06,2,1.3500286881096223e-05,-1,60.86266833170204
1111,supports,3,8.392430028114641e-06,2,1.3500286881096223e-05,-1,60.86266833170204
1112,bromide,3,8.392430028114641e-06,2,1.3500286881096223e-05,-1,60.86266833170204
1113,binding,3,8.392430028114641e-06,2,1.3500286881096223e-05,-1,60.86266833170204
1114,edge,3,8.392430028114641e-06,2,1.3500286881096223e-05,-1,60.86266833170204
1115,shellac,3,8.392430028114641e-06,2,1.3500286881096223e-05,-1,60.86266833170204
1116,software,3,8.392430028114641e-06,2,1.3500286881096223e-05,-1,60.86266833170204
1117,vials,3,8.392430028114641e-06,2,1.3500286881096223e-05,-1,60.86266833170204
1118,heat,3,8.392430028114641e-06,2,1.3500286881096223e-05,-1,60.86266833170204
1119,skin,3,8.392430028114641e-06,2,1.3500286881096223e-05,-1,60.86266833170204
1120,boat,3,8.392430028114641e-06,2,1.3500286881096223e-05,-1,60.86266833170204
1121,silverpoint,3,8.392430028114641e-06,2,1.3500286881096223e-05,-1,60.86266833170204
1122,sycamore,3,8.392430028114641e-06,2,1.3500286881096223e-05,-1,60.86266833170204
1123,flexible,3,8.392430028114641e-06,2,1.3500286881096223e-05,-1,60.86266833170204
1124,sponge,3,8.392430028114641e-06,2,1.3500286881096223e-05,-1,60.86266833170204
1125,bodycolor,3,8.392430028114641e-06,2,1.3500286881096223e-05,-1,60.86266833170204
1126,belt,3,8.392430028114641e-06,2,1.3500286881096223e-05,-1,60.86266833170204
1127,offwhite,3,8.392430028114641e-06,2,1.3500286881096223e-05,-1,60.86266833170204
1128,needle,3,8.392430028114641e-06,2,1.3500286881096223e-05,-1,60.86266833170204
1129,suit,3,8.392430028114641e-06,2,1.3500286881096223e-05,-1,60.86266833170204
1130,clothcovered,3,8.392430028114641e-06,2,1.3500286881096223e-05,-1,60.86266833170204
1131,gelatinsilver,3,8.392430028114641e-06,2,1.3500286881096223e-05,-1,60.86266833170204
1132,flexi,3,8.392430028114641e-06,2,1.3500286881096223e-05,-1,60.86266833170204
1133,scale,3,8.392430028114641e-06,2,1.3500286881096223e-05,-1,60.86266833170204
1134,invitation,3,8.392430028114641e-06,2,1.3500286881096223e-05,-1,60.86266833170204
1135,socket,3,8.392430028114641e-06,2,1.3500286881096223e-05,-1,60.86266833170204
1136,statement,3,8.392430028114641e-06,2,1.3500286881096223e-05,-1,60.86266833170204
1137,oilbased,3,8.392430028114641e-06,2,1.3500286881096223e-05,-1,60.86266833170204
1138,canvasboard,3,8.392430028114641e-06,2,1.3500286881096223e-05,-1,60.86266833170204
1139,flag,3,8.392430028114641e-06,2,1.3500286881096223e-05,-1,60.86266833170204
1140,freundlich,3,8.392430028114641e-06,2,1.3500286881096223e-05,-1,60.86266833170204
1141,franz,3,8.392430028114641e-06,2,1.3500286881096223e-05,-1,60.86266833170204
1142,goldbaum,3,8.392430028114641e-06,2,1.3500286881096223e-05,-1,60.86266833170204
1143,bird,3,8.392430028114641e-06,2,1.3500286881096223e-05,-1,60.86266833170204
1144,arthur,3,8.392430028114641e-06,2,1.3500286881096223e-05,-1,60.86266833170204
1145,sheeting,3,8.392430028114641e-06,2,1.3500286881096223e-05,-1,60.86266833170204
1146,stocking,3,8.392430028114641e-06,2,1.3500286881096223e-05,-1,60.86266833170204
1147,incomplete,3,8.392430028114641e-06,2,1.3500286881096223e-05,-1,60.86266833170204
1148,strohmeyer,3,8.392430028114641e-06,2,1.3500286881096223e-05,-1,60.86266833170204
1149,ottheinrich,3,8.392430028114641e-06,2,1.3500286881096223e-05,-1,60.86266833170204
1150,abraded,3,8.392430028114641e-06,2,1.3500286881096223e-05,-1,60.86266833170204
1151,beam,3,8.392430028114641e-06,2,1.3500286881096223e-05,-1,60.86266833170204
1152,television,3,8.392430028114641e-06,2,1.3500286881096223e-05,-1,60.86266833170204
1153,fly,3,8.392430028114641e-06,2,1.3500286881096223e-05,-1,60.86266833170204
1154,thirtythree,3,8.392430028114641e-06,2,1.3500286881096223e-05,-1,60.86266833170204
1155,photogravure\r\n,3,8.392430028114641e-06,2,1.3500286881096223e-05,-1,60.86266833170204
1156,pattern,3,8.392430028114641e-06,2,1.3500286881096223e-05,-1,60.86266833170204
1157,graphite\r\n,3,8.392430028114641e-06,2,1.3500286881096223e-05,-1,60.86266833170204
1158,herbert,3,8.392430028114641e-06,2,1.3500286881096223e-05,-1,60.86266833170204
1159,mud,3,8.392430028114641e-06,2,1.3500286881096223e-05,-1,60.86266833170204
1160,embedded,3,8.392430028114641e-06,2,1.3500286881096223e-05,-1,60.86266833170204
1161,printed\r\n,3,8.392430028114641e-06,2,1.3500286881096223e-05,-1,60.86266833170204
1162,second,3,8.392430028114641e-06,2,1.3500286881096223e-05,-1,60.86266833170204
1163,tree,3,8.392430028114641e-06,2,1.3500286881096223e-05,-1,60.86266833170204
1164,g,3,8.392430028114641e-06,2,1.3500286881096223e-05,-1,60.86266833170204
1165,eye,3,8.392430028114641e-06,2,1.3500286881096223e-05,-1,60.86266833170204
1166,trash,3,8.392430028114641e-06,2,1.3500286881096223e-05,-1,60.86266833170204
1167,schad,3,8.392430028114641e-06,2,1.3500286881096223e-05,-1,60.86266833170204
1168,progressive,3,8.392430028114641e-06,2,1.3500286881096223e-05,-1,60.86266833170204
1169,bookplate,3,8.392430028114641e-06,2,1.3500286881096223e-05,-1,60.86266833170204
1170,fiftyfour,3,8.392430028114641e-06,2,1.3500286881096223e-05,-1,60.86266833170204
1171,cutand,3,8.392430028114641e-06,2,1.3500286881096223e-05,-1,60.86266833170204
1172,computer,3,8.392430028114641e-06,2,1.3500286881096223e-05,-1,60.86266833170204
1173,potato,3,8.392430028114641e-06,2,1.3500286881096223e-05,-1,60.86266833170204
1174,berlit,3,8.392430028114641e-06,2,1.3500286881096223e-05,-1,60.86266833170204
1175,october,3,8.392430028114641e-06,2,1.3500286881096223e-05,-1,60.86266833170204
1176,headpieces,3,8.392430028114641e-06,2,1.3500286881096223e-05,-1,60.86266833170204
1177,sculpture,3,8.392430028114641e-06,2,1.3500286881096223e-05,-1,60.86266833170204
1178,rüdiger,3,8.392430028114641e-06,2,1.3500286881096223e-05,-1,60.86266833170204
1179,spiral,3,8.392430028114641e-06,2,1.3500286881096223e-05,-1,60.86266833170204
1180,decorative,3,8.392430028114641e-06,2,1.3500286881096223e-05,-1,60.86266833170204
1181,urethane,3,8.392430028114641e-06,2,1.3500286881096223e-05,-1,60.86266833170204
1182,beye,3,8.392430028114641e-06,2,1.3500286881096223e-05,-1,60.86266833170204
1183,christian,3,8.392430028114641e-06,2,1.3500286881096223e-05,-1,60.86266833170204
1184,w,3,8.392430028114641e-06,2,1.3500286881096223e-05,-1,60.86266833170204
1185,optical,2,5.594953352076427e-06,2,1.3500286881096223e-05,0,141.2940024975531
1186,deck,2,5.594953352076427e-06,2,1.3500286881096223e-05,0,141.2940024975531
1187,slip,2,5.594953352076427e-06,2,1.3500286881096223e-05,0,141.2940024975531
1188,knob,2,5.594953352076427e-06,2,1.3500286881096223e-05,0,141.2940024975531
1189,sound\r\n,2,5.594953352076427e-06,2,1.3500286881096223e-05,0,141.2940024975531
1190,dowel,2,5.594953352076427e-06,2,1.3500286881096223e-05,0,141.2940024975531
1191,date,2,5.594953352076427e-06,2,1.3500286881096223e-05,0,141.2940024975531
1192,jerzy,2,5.594953352076427e-06,2,1.3500286881096223e-05,0,141.2940024975531
1193,tempered,2,5.594953352076427e-06,2,1.3500286881096223e-05,0,141.2940024975531
1194,carboard,2,5.594953352076427e-06,2,1.3500286881096223e-05,0,141.2940024975531
1195,sixchannel,2,5.594953352076427e-06,2,1.3500286881096223e-05,0,141.2940024975531
1196,photoradiogram,2,5.594953352076427e-06,2,1.3500286881096223e-05,0,141.2940024975531
1197,tabletop,2,5.594953352076427e-06,2,1.3500286881096223e-05,0,141.2940024975531
1198,imprint,2,5.594953352076427e-06,2,1.3500286881096223e-05,0,141.2940024975531
1199,cups,2,5.594953352076427e-06,2,1.3500286881096223e-05,0,141.2940024975531
1200,chemical,2,5.594953352076427e-06,2,1.3500286881096223e-05,0,141.2940024975531
1201,briefcase,2,5.594953352076427e-06,2,1.3500286881096223e-05,0,141.2940024975531
1202,hulewicz,2,5.594953352076427e-06,2,1.3500286881096223e-05,0,141.2940024975531
1203,pressure,2,5.594953352076427e-06,2,1.3500286881096223e-05,0,141.2940024975531
1204,heinrichsalze,2,5.594953352076427e-06,2,1.3500286881096223e-05,0,141.2940024975531
1205,pierced,2,5.594953352076427e-06,2,1.3500286881096223e-05,0,141.2940024975531
1206,cedar,2,5.594953352076427e-06,2,1.3500286881096223e-05,0,141.2940024975531
1207,paper\r\nh,2,5.594953352076427e-06,2,1.3500286881096223e-05,0,141.2940024975531
1208,rabbit,2,5.594953352076427e-06,2,1.3500286881096223e-05,0,141.2940024975531
1209,thermoplastic,2,5.594953352076427e-06,2,1.3500286881096223e-05,0,141.2940024975531
1210,paper\r\ng,2,5.594953352076427e-06,2,1.3500286881096223e-05,0,141.2940024975531
1211,lamps,2,5.594953352076427e-06,2,1.3500286881096223e-05,0,141.2940024975531
1212,impact,2,5.594953352076427e-06,2,1.3500286881096223e-05,0,141.2940024975531
1213,hoerle,2,5.594953352076427e-06,2,1.3500286881096223e-05,0,141.2940024975531
1214,quilted,2,5.594953352076427e-06,2,1.3500286881096223e-05,0,141.2940024975531
1215,created,2,5.594953352076427e-06,2,1.3500286881096223e-05,0,141.2940024975531
1216,rawhide,2,5.594953352076427e-06,2,1.3500286881096223e-05,0,141.2940024975531
1217,painting,2,5.594953352076427e-06,2,1.3500286881096223e-05,0,141.2940024975531
1218,cowhide,2,5.594953352076427e-06,2,1.3500286881096223e-05,0,141.2940024975531
1219,documenting,2,5.594953352076427e-06,2,1.3500286881096223e-05,0,141.2940024975531
1220,threesheet,2,5.594953352076427e-06,2,1.3500286881096223e-05,0,141.2940024975531
1221,lenses,2,5.594953352076427e-06,2,1.3500286881096223e-05,0,141.2940024975531
1222,traces,2,5.594953352076427e-06,2,1.3500286881096223e-05,0,141.2940024975531
1223,matchbox,2,5.594953352076427e-06,2,1.3500286881096223e-05,0,141.2940024975531
1224,cigarettes,2,5.594953352076427e-06,2,1.3500286881096223e-05,0,141.2940024975531
1225,augusta,2,5.594953352076427e-06,2,1.3500286881096223e-05,0,141.2940024975531
1226,wild,2,5.594953352076427e-06,2,1.3500286881096223e-05,0,141.2940024975531
1227,zitzewitz,2,5.594953352076427e-06,2,1.3500286881096223e-05,0,141.2940024975531
1228,stanislaw,2,5.594953352076427e-06,2,1.3500286881096223e-05,0,141.2940024975531
1229,luis,2,5.594953352076427e-06,2,1.3500286881096223e-05,0,141.2940024975531
1230,julius,2,5.594953352076427e-06,2,1.3500286881096223e-05,0,141.2940024975531
1231,gun,2,5.594953352076427e-06,2,1.3500286881096223e-05,0,141.2940024975531
1232,shot,2,5.594953352076427e-06,2,1.3500286881096223e-05,0,141.2940024975531
1233,h,2,5.594953352076427e-06,2,1.3500286881096223e-05,0,141.2940024975531
1234,reworked,2,5.594953352076427e-06,2,1.3500286881096223e-05,0,141.2940024975531
1235,kubicki,2,5.594953352076427e-06,2,1.3500286881096223e-05,0,141.2940024975531
1236,heise,2,5.594953352076427e-06,2,1.3500286881096223e-05,0,141.2940024975531
1237,handtinted,2,5.594953352076427e-06,2,1.3500286881096223e-05,0,141.2940024975531
1238,katharina,2,5.594953352076427e-06,2,1.3500286881096223e-05,0,141.2940024975531
1239,kaufmann,2,5.594953352076427e-06,2,1.3500286881096223e-05,0,141.2940024975531
1240,“,2,5.594953352076427e-06,2,1.3500286881096223e-05,0,141.2940024975531
1241,tie,2,5.594953352076427e-06,2,1.3500286881096223e-05,0,141.2940024975531
1242,baseball,2,5.594953352076427e-06,2,1.3500286881096223e-05,0,141.2940024975531
1243,”,2,5.594953352076427e-06,2,1.3500286881096223e-05,0,141.2940024975531
1244,length,2,5.594953352076427e-06,2,1.3500286881096223e-05,0,141.2940024975531
1245,graphics,2,5.594953352076427e-06,2,1.3500286881096223e-05,0,141.2940024975531
1246,glaze,2,5.594953352076427e-06,2,1.3500286881096223e-05,0,141.2940024975531
1247,british,2,5.594953352076427e-06,2,1.3500286881096223e-05,0,141.2940024975531
1248,american,2,5.594953352076427e-06,2,1.3500286881096223e-05,0,141.2940024975531
1249,multimedia,2,5.594953352076427e-06,2,1.3500286881096223e-05,0,141.2940024975531
1250,plug,2,5.594953352076427e-06,2,1.3500286881096223e-05,0,141.2940024975531
1251,magnesium,2,5.594953352076427e-06,2,1.3500286881096223e-05,0,141.2940024975531
1252,placemat,2,5.594953352076427e-06,2,1.3500286881096223e-05,0,141.2940024975531
1253,coil,2,5.594953352076427e-06,2,1.3500286881096223e-05,0,141.2940024975531
1254,grass,2,5.594953352076427e-06,2,1.3500286881096223e-05,0,141.2940024975531
1255,drawn,2,5.594953352076427e-06,2,1.3500286881096223e-05,0,141.2940024975531
1256,chewing,2,5.594953352076427e-06,2,1.3500286881096223e-05,0,141.2940024975531
1257,total,2,5.594953352076427e-06,2,1.3500286881096223e-05,0,141.2940024975531
1258,après,2,5.594953352076427e-06,2,1.3500286881096223e-05,0,141.2940024975531
1259,decal,2,5.594953352076427e-06,2,1.3500286881096223e-05,0,141.2940024975531
1260,der,2,5.594953352076427e-06,2,1.3500286881096223e-05,0,141.2940024975531
1261,mixografia,2,5.594953352076427e-06,2,1.3500286881096223e-05,0,141.2940024975531
1262,disks,2,5.594953352076427e-06,2,1.3500286881096223e-05,0,141.2940024975531
1263,support,2,5.594953352076427e-06,2,1.3500286881096223e-05,0,141.2940024975531
1264,knife,2,5.594953352076427e-06,2,1.3500286881096223e-05,0,141.2940024975531
1265,pads,2,5.594953352076427e-06,2,1.3500286881096223e-05,0,141.2940024975531
1266,veneered,2,5.594953352076427e-06,2,1.3500286881096223e-05,0,141.2940024975531
1267,cinema,2,5.594953352076427e-06,2,1.3500286881096223e-05,0,141.2940024975531
1268,wrap,2,5.594953352076427e-06,2,1.3500286881096223e-05,0,141.2940024975531
1269,tar,2,5.594953352076427e-06,2,1.3500286881096223e-05,0,141.2940024975531
1270,following,2,5.594953352076427e-06,2,1.3500286881096223e-05,0,141.2940024975531
1271,human,2,5.594953352076427e-06,2,1.3500286881096223e-05,0,141.2940024975531
1272,acidetched,2,5.594953352076427e-06,2,1.3500286881096223e-05,0,141.2940024975531
1273,patterned,2,5.594953352076427e-06,2,1.3500286881096223e-05,0,141.2940024975531
1274,pasedag,2,5.594953352076427e-06,2,1.3500286881096223e-05,0,141.2940024975531
1275,pieced,2,5.594953352076427e-06,2,1.3500286881096223e-05,0,141.2940024975531
1276,eightyone,2,5.594953352076427e-06,2,1.3500286881096223e-05,0,141.2940024975531
1277,pillow,2,5.594953352076427e-06,2,1.3500286881096223e-05,0,141.2940024975531
1278,pot,2,5.594953352076427e-06,2,1.3500286881096223e-05,0,141.2940024975531
1279,rubbed,2,5.594953352076427e-06,2,1.3500286881096223e-05,0,141.2940024975531
1280,tool,2,5.594953352076427e-06,2,1.3500286881096223e-05,0,141.2940024975531
1281,lisa,2,5.594953352076427e-06,2,1.3500286881096223e-05,0,141.2940024975531
1282,shoebox,2,5.594953352076427e-06,2,1.3500286881096223e-05,0,141.2940024975531
1283,rpm,2,5.594953352076427e-06,2,1.3500286881096223e-05,0,141.2940024975531
1284,industrial,2,5.594953352076427e-06,2,1.3500286881096223e-05,0,141.2940024975531
1285,walter,2,5.594953352076427e-06,2,1.3500286881096223e-05,0,141.2940024975531
1286,push,2,5.594953352076427e-06,2,1.3500286881096223e-05,0,141.2940024975531
1287,bricks,2,5.594953352076427e-06,2,1.3500286881096223e-05,0,141.2940024975531
1288,moss,2,5.594953352076427e-06,2,1.3500286881096223e-05,0,141.2940024975531
1289,publication,2,5.594953352076427e-06,2,1.3500286881096223e-05,0,141.2940024975531
1290,modern,2,5.594953352076427e-06,2,1.3500286881096223e-05,0,141.2940024975531
1291,collage\r\n,2,5.594953352076427e-06,2,1.3500286881096223e-05,0,141.2940024975531
1292,windows,2,5.594953352076427e-06,2,1.3500286881096223e-05,0,141.2940024975531
1293,bluegray,2,5.594953352076427e-06,2,1.3500286881096223e-05,0,141.2940024975531
1294,forged,2,5.594953352076427e-06,2,1.3500286881096223e-05,0,141.2940024975531
1295,figurine,2,5.594953352076427e-06,2,1.3500286881096223e-05,0,141.2940024975531
1296,raw,2,5.594953352076427e-06,2,1.3500286881096223e-05,0,141.2940024975531
1297,imitation,2,5.594953352076427e-06,2,1.3500286881096223e-05,0,141.2940024975531
1298,meat,2,5.594953352076427e-06,2,1.3500286881096223e-05,0,141.2940024975531
1299,punching,2,5.594953352076427e-06,2,1.3500286881096223e-05,0,141.2940024975531
1300,bar,2,5.594953352076427e-06,2,1.3500286881096223e-05,0,141.2940024975531
1301,eraser,2,5.594953352076427e-06,2,1.3500286881096223e-05,0,141.2940024975531
1302,schulze,2,5.594953352076427e-06,2,1.3500286881096223e-05,0,141.2940024975531
1303,grimm,2,5.594953352076427e-06,2,1.3500286881096223e-05,0,141.2940024975531
1304,cylinders,2,5.594953352076427e-06,2,1.3500286881096223e-05,0,141.2940024975531
1305,corner,2,5.594953352076427e-06,2,1.3500286881096223e-05,0,141.2940024975531
1306,willi,2,5.594953352076427e-06,2,1.3500286881096223e-05,0,141.2940024975531
1307,sulfur,2,5.594953352076427e-06,2,1.3500286881096223e-05,0,141.2940024975531
1308,tegtmeier,2,5.594953352076427e-06,2,1.3500286881096223e-05,0,141.2940024975531
1309,antenna,2,5.594953352076427e-06,2,1.3500286881096223e-05,0,141.2940024975531
1310,poland,2,5.594953352076427e-06,2,1.3500286881096223e-05,0,141.2940024975531
1311,foamboard,2,5.594953352076427e-06,2,1.3500286881096223e-05,0,141.2940024975531
1312,documentary,2,5.594953352076427e-06,2,1.3500286881096223e-05,0,141.2940024975531
1313,separate,2,5.594953352076427e-06,2,1.3500286881096223e-05,0,141.2940024975531
1314,made,2,5.594953352076427e-06,2,1.3500286881096223e-05,0,141.2940024975531
1315,raoul,2,5.594953352076427e-06,2,1.3500286881096223e-05,0,141.2940024975531
1316,drilled,2,5.594953352076427e-06,2,1.3500286881096223e-05,0,141.2940024975531
1317,marie,2,5.594953352076427e-06,2,1.3500286881096223e-05,0,141.2940024975531
1318,ruler,2,5.594953352076427e-06,2,1.3500286881096223e-05,0,141.2940024975531
1319,laquered,2,5.594953352076427e-06,2,1.3500286881096223e-05,0,141.2940024975531
1320,transistor,2,5.594953352076427e-06,2,1.3500286881096223e-05,0,141.2940024975531
1321,small,2,5.594953352076427e-06,2,1.3500286881096223e-05,0,141.2940024975531
1322,section,2,5.594953352076427e-06,2,1.3500286881096223e-05,0,141.2940024975531
1323,pyrex,2,5.594953352076427e-06,2,1.3500286881096223e-05,0,141.2940024975531
1324,stool,2,5.594953352076427e-06,2,1.3500286881096223e-05,0,141.2940024975531
1325,mirrored,2,5.594953352076427e-06,2,1.3500286881096223e-05,0,141.2940024975531
1326,spool,2,5.594953352076427e-06,2,1.3500286881096223e-05,0,141.2940024975531
1327,knit,2,5.594953352076427e-06,2,1.3500286881096223e-05,0,141.2940024975531
1328,manilla,2,5.594953352076427e-06,2,1.3500286881096223e-05,0,141.2940024975531
1329,diameter,2,5.594953352076427e-06,2,1.3500286881096223e-05,0,141.2940024975531
1330,f,2,5.594953352076427e-06,2,1.3500286881096223e-05,0,141.2940024975531
1331,disk,2,5.594953352076427e-06,2,1.3500286881096223e-05,0,141.2940024975531
1332,core,2,5.594953352076427e-06,2,1.3500286881096223e-05,0,141.2940024975531
1333,suitcase,2,5.594953352076427e-06,2,1.3500286881096223e-05,0,141.2940024975531
1334,sandblasted,2,5.594953352076427e-06,2,1.3500286881096223e-05,0,141.2940024975531
1335,vitrine,2,5.594953352076427e-06,1,6.750143440548112e-06,-1,20.64700124877654
1336,burnished,2,5.594953352076427e-06,1,6.750143440548112e-06,-1,20.64700124877654
1337,curtain,2,5.594953352076427e-06,1,6.750143440548112e-06,-1,20.64700124877654
1338,furniture,2,5.594953352076427e-06,1,6.750143440548112e-06,-1,20.64700124877654
1339,battery,2,5.594953352076427e-06,1,6.750143440548112e-06,-1,20.64700124877654
1340,flyer,2,5.594953352076427e-06,1,6.750143440548112e-06,-1,20.64700124877654
1341,mattress,2,5.594953352076427e-06,1,6.750143440548112e-06,-1,20.64700124877654
1342,test,2,5.594953352076427e-06,1,6.750143440548112e-06,-1,20.64700124877654
1343,dollar,2,5.594953352076427e-06,1,6.750143440548112e-06,-1,20.64700124877654
1344,packaging,2,5.594953352076427e-06,1,6.750143440548112e-06,-1,20.64700124877654
1345,vacuum,2,5.594953352076427e-06,1,6.750143440548112e-06,-1,20.64700124877654
1346,facsimile,2,5.594953352076427e-06,1,6.750143440548112e-06,-1,20.64700124877654
1347,thermography,2,5.594953352076427e-06,1,6.750143440548112e-06,-1,20.64700124877654
1348,basin,2,5.594953352076427e-06,1,6.750143440548112e-06,-1,20.64700124877654
1349,mask,2,5.594953352076427e-06,1,6.750143440548112e-06,-1,20.64700124877654
1350,pumps,2,5.594953352076427e-06,1,6.750143440548112e-06,-1,20.64700124877654
1351,fortyeight,2,5.594953352076427e-06,1,6.750143440548112e-06,-1,20.64700124877654
1352,antique,2,5.594953352076427e-06,1,6.750143440548112e-06,-1,20.64700124877654
1353,hammer,2,5.594953352076427e-06,1,6.750143440548112e-06,-1,20.64700124877654
1354,auvergne,2,5.594953352076427e-06,1,6.750143440548112e-06,-1,20.64700124877654
1355,collaboration,2,5.594953352076427e-06,1,6.750143440548112e-06,-1,20.64700124877654
1356,linotype,2,5.594953352076427e-06,1,6.750143440548112e-06,-1,20.64700124877654
1357,within,2,5.594953352076427e-06,1,6.750143440548112e-06,-1,20.64700124877654
1358,fishing,2,5.594953352076427e-06,1,6.750143440548112e-06,-1,20.64700124877654
1359,popups,2,5.594953352076427e-06,1,6.750143440548112e-06,-1,20.64700124877654
1360,crt,2,5.594953352076427e-06,1,6.750143440548112e-06,-1,20.64700124877654
1361,crushed,2,5.594953352076427e-06,1,6.750143440548112e-06,-1,20.64700124877654
1362,salt,2,5.594953352076427e-06,1,6.750143440548112e-06,-1,20.64700124877654
1363,song,2,5.594953352076427e-06,1,6.750143440548112e-06,-1,20.64700124877654
1364,river,2,5.594953352076427e-06,1,6.750143440548112e-06,-1,20.64700124877654
1365,hot,2,5.594953352076427e-06,1,6.750143440548112e-06,-1,20.64700124877654
1366,compact,2,5.594953352076427e-06,1,6.750143440548112e-06,-1,20.64700124877654
1367,wtih,2,5.594953352076427e-06,1,6.750143440548112e-06,-1,20.64700124877654
1368,stuffing,2,5.594953352076427e-06,1,6.750143440548112e-06,-1,20.64700124877654
1369,stove,2,5.594953352076427e-06,1,6.750143440548112e-06,-1,20.64700124877654
1370,wrist,2,5.594953352076427e-06,1,6.750143440548112e-06,-1,20.64700124877654
1371,york,2,5.594953352076427e-06,1,6.750143440548112e-06,-1,20.64700124877654
1372,karat,2,5.594953352076427e-06,1,6.750143440548112e-06,-1,20.64700124877654
1373,frame\r\n,2,5.594953352076427e-06,1,6.750143440548112e-06,-1,20.64700124877654
1374,zipper,2,5.594953352076427e-06,1,6.750143440548112e-06,-1,20.64700124877654
1375,threedimensional,2,5.594953352076427e-06,1,6.750143440548112e-06,-1,20.64700124877654
1376,included,2,5.594953352076427e-06,1,6.750143440548112e-06,-1,20.64700124877654
1377,net,2,5.594953352076427e-06,1,6.750143440548112e-06,-1,20.64700124877654
1378,exterior,2,5.594953352076427e-06,1,6.750143440548112e-06,-1,20.64700124877654
1379,city,2,5.594953352076427e-06,1,6.750143440548112e-06,-1,20.64700124877654
1380,granite,2,5.594953352076427e-06,1,6.750143440548112e-06,-1,20.64700124877654
1381,magnet,2,5.594953352076427e-06,1,6.750143440548112e-06,-1,20.64700124877654
1382,powdercoated,2,5.594953352076427e-06,1,6.750143440548112e-06,-1,20.64700124877654
1383,tag,2,5.594953352076427e-06,1,6.750143440548112e-06,-1,20.64700124877654
1384,unpainted,2,5.594953352076427e-06,1,6.750143440548112e-06,-1,20.64700124877654
1385,asphalt,2,5.594953352076427e-06,1,6.750143440548112e-06,-1,20.64700124877654
1386,clamp,2,5.594953352076427e-06,1,6.750143440548112e-06,-1,20.64700124877654
1387,schmidtrottluff,2,5.594953352076427e-06,1,6.750143440548112e-06,-1,20.64700124877654
1388,pebble,2,5.594953352076427e-06,1,6.750143440548112e-06,-1,20.64700124877654
1389,diamond,2,5.594953352076427e-06,1,6.750143440548112e-06,-1,20.64700124877654
1390,decals,2,5.594953352076427e-06,1,6.750143440548112e-06,-1,20.64700124877654
1391,richterberlin,2,5.594953352076427e-06,1,6.750143440548112e-06,-1,20.64700124877654
1392,matboard,2,5.594953352076427e-06,1,6.750143440548112e-06,-1,20.64700124877654
1393,collection,2,5.594953352076427e-06,1,6.750143440548112e-06,-1,20.64700124877654
1394,system,2,5.594953352076427e-06,1,6.750143440548112e-06,-1,20.64700124877654
1395,lamp,2,5.594953352076427e-06,1,6.750143440548112e-06,-1,20.64700124877654
1396,fluxus,2,5.594953352076427e-06,1,6.750143440548112e-06,-1,20.64700124877654
1397,prospectus,2,5.594953352076427e-06,1,6.750143440548112e-06,-1,20.64700124877654
1398,sixty,2,5.594953352076427e-06,1,6.750143440548112e-06,-1,20.64700124877654
1399,identical,2,5.594953352076427e-06,1,6.750143440548112e-06,-1,20.64700124877654
1400,form,2,5.594953352076427e-06,1,6.750143440548112e-06,-1,20.64700124877654
1401,richter,2,5.594953352076427e-06,1,6.750143440548112e-06,-1,20.64700124877654
1402,pale,2,5.594953352076427e-06,1,6.750143440548112e-06,-1,20.64700124877654
1403,archive,2,5.594953352076427e-06,1,6.750143440548112e-06,-1,20.64700124877654
1404,whiteout,2,5.594953352076427e-06,1,6.750143440548112e-06,-1,20.64700124877654
1405,leaded,2,5.594953352076427e-06,1,6.750143440548112e-06,-1,20.64700124877654
1406,using,2,5.594953352076427e-06,1,6.750143440548112e-06,-1,20.64700124877654
1407,segal,2,5.594953352076427e-06,1,6.750143440548112e-06,-1,20.64700124877654
1408,tea,2,5.594953352076427e-06,1,6.750143440548112e-06,-1,20.64700124877654
1409,expanded,2,5.594953352076427e-06,1,6.750143440548112e-06,-1,20.64700124877654
1410,pad,2,5.594953352076427e-06,1,6.750143440548112e-06,-1,20.64700124877654
1411,individual,2,5.594953352076427e-06,1,6.750143440548112e-06,-1,20.64700124877654
1412,bells,2,5.594953352076427e-06,1,6.750143440548112e-06,-1,20.64700124877654
1413,hans,2,5.594953352076427e-06,1,6.750143440548112e-06,-1,20.64700124877654
1414,beige,2,5.594953352076427e-06,1,6.750143440548112e-06,-1,20.64700124877654
1415,fasteners,2,5.594953352076427e-06,1,6.750143440548112e-06,-1,20.64700124877654
1416,ledger,2,5.594953352076427e-06,1,6.750143440548112e-06,-1,20.64700124877654
1417,skull,2,5.594953352076427e-06,1,6.750143440548112e-06,-1,20.64700124877654
1418,square,2,5.594953352076427e-06,1,6.750143440548112e-06,-1,20.64700124877654
1419,viewing,2,5.594953352076427e-06,1,6.750143440548112e-06,-1,20.64700124877654
1420,chips,2,5.594953352076427e-06,1,6.750143440548112e-06,-1,20.64700124877654
1421,slabs,2,5.594953352076427e-06,1,6.750143440548112e-06,-1,20.64700124877654
1422,size,2,5.594953352076427e-06,1,6.750143440548112e-06,-1,20.64700124877654
1423,threepart,2,5.594953352076427e-06,1,6.750143440548112e-06,-1,20.64700124877654
1424,necklace,2,5.594953352076427e-06,1,6.750143440548112e-06,-1,20.64700124877654
1425,soil,2,5.594953352076427e-06,1,6.750143440548112e-06,-1,20.64700124877654
1426,spoon,2,5.594953352076427e-06,1,6.750143440548112e-06,-1,20.64700124877654
1427,cup,2,5.594953352076427e-06,1,6.750143440548112e-06,-1,20.64700124877654
1428,iodine,1,2.797476676038213e-06,1,6.750143440548112e-06,0,141.29400249755312
1429,stationary,1,2.797476676038213e-06,1,6.750143440548112e-06,0,141.29400249755312
1430,pva,1,2.797476676038213e-06,1,6.750143440548112e-06,0,141.29400249755312
1431,pig,1,2.797476676038213e-06,1,6.750143440548112e-06,0,141.29400249755312
1432,cardboard\r\n,1,2.797476676038213e-06,1,6.750143440548112e-06,0,141.29400249755312
1433,iink,1,2.797476676038213e-06,1,6.750143440548112e-06,0,141.29400249755312
1434,acoustic,1,2.797476676038213e-06,1,6.750143440548112e-06,0,141.29400249755312
1435,spreads,1,2.797476676038213e-06,1,6.750143440548112e-06,0,141.29400249755312
1436,structure,1,2.797476676038213e-06,1,6.750143440548112e-06,0,141.29400249755312
1437,ephemeral,1,2.797476676038213e-06,1,6.750143440548112e-06,0,141.29400249755312
1438,wedge,1,2.797476676038213e-06,1,6.750143440548112e-06,0,141.29400249755312
1439,text\r\n,1,2.797476676038213e-06,1,6.750143440548112e-06,0,141.29400249755312
1440,soundtrack,1,2.797476676038213e-06,1,6.750143440548112e-06,0,141.29400249755312
1441,early,1,2.797476676038213e-06,1,6.750143440548112e-06,0,141.29400249755312
1442,particleboard,1,2.797476676038213e-06,1,6.750143440548112e-06,0,141.29400249755312
1443,approx,1,2.797476676038213e-06,1,6.750143440548112e-06,0,141.29400249755312
1444,modified,1,2.797476676038213e-06,1,6.750143440548112e-06,0,141.29400249755312
1445,builtin,1,2.797476676038213e-06,1,6.750143440548112e-06,0,141.29400249755312
1446,amplifier,1,2.797476676038213e-06,1,6.750143440548112e-06,0,141.29400249755312
1447,drawer,1,2.797476676038213e-06,1,6.750143440548112e-06,0,141.29400249755312
1448,action,1,2.797476676038213e-06,1,6.750143440548112e-06,0,141.29400249755312
1449,ferrule,1,2.797476676038213e-06,1,6.750143440548112e-06,0,141.29400249755312
1450,aktion,1,2.797476676038213e-06,1,6.750143440548112e-06,0,141.29400249755312
1451,mould,1,2.797476676038213e-06,1,6.750143440548112e-06,0,141.29400249755312
1452,patch,1,2.797476676038213e-06,1,6.750143440548112e-06,0,141.29400249755312
1453,ab,1,2.797476676038213e-06,1,6.750143440548112e-06,0,141.29400249755312
1454,headphones,1,2.797476676038213e-06,1,6.750143440548112e-06,0,141.29400249755312
1455,rust,1,2.797476676038213e-06,1,6.750143440548112e-06,0,141.29400249755312
1456,stools,1,2.797476676038213e-06,1,6.750143440548112e-06,0,141.29400249755312
1457,pair,1,2.797476676038213e-06,1,6.750143440548112e-06,0,141.29400249755312
1458,flashe,1,2.797476676038213e-06,1,6.750143440548112e-06,0,141.29400249755312
1459,evening,1,2.797476676038213e-06,1,6.750143440548112e-06,0,141.29400249755312
1460,held,1,2.797476676038213e-06,1,6.750143440548112e-06,0,141.29400249755312
1461,embroidery,1,2.797476676038213e-06,1,6.750143440548112e-06,0,141.29400249755312
1462,juice,1,2.797476676038213e-06,1,6.750143440548112e-06,0,141.29400249755312
1463,snow,1,2.797476676038213e-06,1,6.750143440548112e-06,0,141.29400249755312
1464,examples,1,2.797476676038213e-06,1,6.750143440548112e-06,0,141.29400249755312
1465,xeroxes,1,2.797476676038213e-06,1,6.750143440548112e-06,0,141.29400249755312
1466,gridded,1,2.797476676038213e-06,1,6.750143440548112e-06,0,141.29400249755312
1467,newspaper\r\n,1,2.797476676038213e-06,1,6.750143440548112e-06,0,141.29400249755312
1468,iv,1,2.797476676038213e-06,1,6.750143440548112e-06,0,141.29400249755312
1469,manganese,1,2.797476676038213e-06,1,6.750143440548112e-06,0,141.29400249755312
1470,fox,1,2.797476676038213e-06,1,6.750143440548112e-06,0,141.29400249755312
1471,programmed,1,2.797476676038213e-06,1,6.750143440548112e-06,0,141.29400249755312
1472,barrier,1,2.797476676038213e-06,1,6.750143440548112e-06,0,141.29400249755312
1473,roses,1,2.797476676038213e-06,1,6.750143440548112e-06,0,141.29400249755312
1474,documents,1,2.797476676038213e-06,1,6.750143440548112e-06,0,141.29400249755312
1475,vegetable,1,2.797476676038213e-06,1,6.750143440548112e-06,0,141.29400249755312
1476,pingpong,1,2.797476676038213e-06,1,6.750143440548112e-06,0,141.29400249755312
1477,tied,1,2.797476676038213e-06,1,6.750143440548112e-06,0,141.29400249755312
1478,pellets,1,2.797476676038213e-06,1,6.750143440548112e-06,0,141.29400249755312
1479,movable,1,2.797476676038213e-06,1,6.750143440548112e-06,0,141.29400249755312
1480,lottery,1,2.797476676038213e-06,1,6.750143440548112e-06,0,141.29400249755312
1481,cleaning,1,2.797476676038213e-06,1,6.750143440548112e-06,0,141.29400249755312
1482,droppings,1,2.797476676038213e-06,1,6.750143440548112e-06,0,141.29400249755312
1483,universal,1,2.797476676038213e-06,1,6.750143440548112e-06,0,141.29400249755312
1484,transparencies,1,2.797476676038213e-06,1,6.750143440548112e-06,0,141.29400249755312
1485,parquet,1,2.797476676038213e-06,1,6.750143440548112e-06,0,141.29400249755312
1486,hydrostone,1,2.797476676038213e-06,1,6.750143440548112e-06,0,141.29400249755312
1487,pages\r\n,1,2.797476676038213e-06,1,6.750143440548112e-06,0,141.29400249755312
1488,receivers,1,2.797476676038213e-06,1,6.750143440548112e-06,0,141.29400249755312
1489,office,1,2.797476676038213e-06,1,6.750143440548112e-06,0,141.29400249755312
1490,plaques,1,2.797476676038213e-06,1,6.750143440548112e-06,0,141.29400249755312
1491,wladislav,1,2.797476676038213e-06,1,6.750143440548112e-06,0,141.29400249755312
1492,skotarek,1,2.797476676038213e-06,1,6.750143440548112e-06,0,141.29400249755312
1493,bampi,1,2.797476676038213e-06,1,6.750143440548112e-06,0,141.29400249755312
1494,ines,1,2.797476676038213e-06,1,6.750143440548112e-06,0,141.29400249755312
1495,wetzel,1,2.797476676038213e-06,1,6.750143440548112e-06,0,141.29400249755312
1496,alexander,1,2.797476676038213e-06,1,6.750143440548112e-06,0,141.29400249755312
1497,mathéy,1,2.797476676038213e-06,1,6.750143440548112e-06,0,141.29400249755312
1498,seiwert,1,2.797476676038213e-06,1,6.750143440548112e-06,0,141.29400249755312
1499,maetzel,1,2.797476676038213e-06,1,6.750143440548112e-06,0,141.29400249755312
1500,emil,1,2.797476676038213e-06,1,6.750143440548112e-06,0,141.29400249755312
1501,jakob,1,2.797476676038213e-06,1,6.750143440548112e-06,0,141.29400249755312
1502,friedmannotten,1,2.797476676038213e-06,1,6.750143440548112e-06,0,141.29400249755312
1503,mitzi,1,2.797476676038213e-06,1,6.750143440548112e-06,0,141.29400249755312
1504,rosalie,1,2.797476676038213e-06,1,6.750143440548112e-06,0,141.29400249755312
1505,beyer,1,2.797476676038213e-06,1,6.750143440548112e-06,0,141.29400249755312
1506,ohly,1,2.797476676038213e-06,1,6.750143440548112e-06,0,141.29400249755312
1507,waldemar,1,2.797476676038213e-06,1,6.750143440548112e-06,0,141.29400249755312
1508,slodki,1,2.797476676038213e-06,1,6.750143440548112e-06,0,141.29400249755312
1509,otten,1,2.797476676038213e-06,1,6.750143440548112e-06,0,141.29400249755312
1510,eugen,1,2.797476676038213e-06,1,6.750143440548112e-06,0,141.29400249755312
1511,hoffmann,1,2.797476676038213e-06,1,6.750143440548112e-06,0,141.29400249755312
1512,schwimmer,1,2.797476676038213e-06,1,6.750143440548112e-06,0,141.29400249755312
1513,around,1,2.797476676038213e-06,1,6.750143440548112e-06,0,141.29400249755312
1514,filmstrip,1,2.797476676038213e-06,1,6.750143440548112e-06,0,141.29400249755312
1515,sensitive,1,2.797476676038213e-06,1,6.750143440548112e-06,0,141.29400249755312
1516,soup,1,2.797476676038213e-06,1,6.750143440548112e-06,0,141.29400249755312
1517,twosided,1,2.797476676038213e-06,1,6.750143440548112e-06,0,141.29400249755312
1518,fortyfour,1,2.797476676038213e-06,1,6.750143440548112e-06,0,141.29400249755312
1519,oskar,1,2.797476676038213e-06,1,6.750143440548112e-06,0,141.29400249755312
1520,ideler,1,2.797476676038213e-06,1,6.750143440548112e-06,0,141.29400249755312
1521,lonni,1,2.797476676038213e-06,1,6.750143440548112e-06,0,141.29400249755312
1522,birckenbach,1,2.797476676038213e-06,1,6.750143440548112e-06,0,141.29400249755312
1523,diecutting,1,2.797476676038213e-06,1,6.750143440548112e-06,0,141.29400249755312
1524,postcard\r\n,1,2.797476676038213e-06,1,6.750143440548112e-06,0,141.29400249755312
1525,wig,1,2.797476676038213e-06,1,6.750143440548112e-06,0,141.29400249755312
1526,sensors,1,2.797476676038213e-06,1,6.750143440548112e-06,0,141.29400249755312
1527,dishes,1,2.797476676038213e-06,1,6.750143440548112e-06,0,141.29400249755312
1528,tablecloth,1,2.797476676038213e-06,1,6.750143440548112e-06,0,141.29400249755312
1529,print\r\nx,1,2.797476676038213e-06,1,6.750143440548112e-06,0,141.29400249755312
1530,corduroy,1,2.797476676038213e-06,1,6.750143440548112e-06,0,141.29400249755312
1531,sheetmetal,1,2.797476676038213e-06,1,6.750143440548112e-06,0,141.29400249755312
1532,bristles,1,2.797476676038213e-06,1,6.750143440548112e-06,0,141.29400249755312
1533,group,1,2.797476676038213e-06,1,6.750143440548112e-06,0,141.29400249755312
1534,aerosol,1,2.797476676038213e-06,1,6.750143440548112e-06,0,141.29400249755312
1535,twentynine,1,2.797476676038213e-06,1,6.750143440548112e-06,0,141.29400249755312
1536,disco,1,2.797476676038213e-06,1,6.750143440548112e-06,0,141.29400249755312
1537,handdyed,1,2.797476676038213e-06,1,6.750143440548112e-06,0,141.29400249755312
1538,regular,1,2.797476676038213e-06,1,6.750143440548112e-06,0,141.29400249755312
1539,uv,1,2.797476676038213e-06,1,6.750143440548112e-06,0,141.29400249755312
1540,cage,1,2.797476676038213e-06,1,6.750143440548112e-06,0,141.29400249755312
1541,lipstick,1,2.797476676038213e-06,1,6.750143440548112e-06,0,141.29400249755312
1542,list,1,2.797476676038213e-06,1,6.750143440548112e-06,0,141.29400249755312
1543,flags,1,2.797476676038213e-06,1,6.750143440548112e-06,0,141.29400249755312
1544,amplifiers,1,2.797476676038213e-06,1,6.750143440548112e-06,0,141.29400249755312
1545,factory,1,2.797476676038213e-06,1,6.750143440548112e-06,0,141.29400249755312
1546,ferrous,1,2.797476676038213e-06,1,6.750143440548112e-06,0,141.29400249755312
1547,crate,1,2.797476676038213e-06,1,6.750143440548112e-06,0,141.29400249755312
1548,roll,1,2.797476676038213e-06,1,6.750143440548112e-06,0,141.29400249755312
1549,dayglo,1,2.797476676038213e-06,1,6.750143440548112e-06,0,141.29400249755312
1550,draft,1,2.797476676038213e-06,1,6.750143440548112e-06,0,141.29400249755312
1551,canvas\r\n,1,2.797476676038213e-06,1,6.750143440548112e-06,0,141.29400249755312
1552,stockings,1,2.797476676038213e-06,1,6.750143440548112e-06,0,141.29400249755312
1553,encased,1,2.797476676038213e-06,1,6.750143440548112e-06,0,141.29400249755312
1554,fivechannel,1,2.797476676038213e-06,1,6.750143440548112e-06,0,141.29400249755312
1555,electromagnetic,1,2.797476676038213e-06,1,6.750143440548112e-06,0,141.29400249755312
1556,calendar,1,2.797476676038213e-06,1,6.750143440548112e-06,0,141.29400249755312
1557,variable,1,2.797476676038213e-06,1,6.750143440548112e-06,0,141.29400249755312
1558,props,1,2.797476676038213e-06,1,6.750143440548112e-06,0,141.29400249755312
1559,encyclopedia,1,2.797476676038213e-06,1,6.750143440548112e-06,0,141.29400249755312
1560,threechannel,1,2.797476676038213e-06,1,6.750143440548112e-06,0,141.29400249755312
1561,twochannel,1,2.797476676038213e-06,1,6.750143440548112e-06,0,141.29400249755312
1562,furnace,1,2.797476676038213e-06,1,6.750143440548112e-06,0,141.29400249755312
1563,corset,1,2.797476676038213e-06,1,6.750143440548112e-06,0,141.29400249755312
1564,duck,1,2.797476676038213e-06,1,6.750143440548112e-06,0,141.29400249755312
1565,noisemaker,1,2.797476676038213e-06,1,6.750143440548112e-06,0,141.29400249755312
1566,scorch,1,2.797476676038213e-06,1,6.750143440548112e-06,0,141.29400249755312
1567,grommet,1,2.797476676038213e-06,1,6.750143440548112e-06,0,141.29400249755312
1568,ono,1,2.797476676038213e-06,1,6.750143440548112e-06,0,141.29400249755312
1569,yoko,1,2.797476676038213e-06,1,6.750143440548112e-06,0,141.29400249755312
1570,gallery,1,2.797476676038213e-06,1,6.750143440548112e-06,0,141.29400249755312
1571,related,1,2.797476676038213e-06,1,6.750143440548112e-06,0,141.29400249755312
1572,honeycomb,1,2.797476676038213e-06,1,6.750143440548112e-06,0,141.29400249755312
1573,waste,1,2.797476676038213e-06,1,6.750143440548112e-06,0,141.29400249755312
1574,room,1,2.797476676038213e-06,1,6.750143440548112e-06,0,141.29400249755312
1575,sheet\r\n,1,2.797476676038213e-06,1,6.750143440548112e-06,0,141.29400249755312
1576,alcohol,1,2.797476676038213e-06,1,6.750143440548112e-06,0,141.29400249755312
1577,scrapbook,1,2.797476676038213e-06,1,6.750143440548112e-06,0,141.29400249755312
1578,bucket,1,2.797476676038213e-06,1,6.750143440548112e-06,0,141.29400249755312
1579,safe,1,2.797476676038213e-06,1,6.750143440548112e-06,0,141.29400249755312
1580,steam,1,2.797476676038213e-06,1,6.750143440548112e-06,0,141.29400249755312
1581,photocopied,1,2.797476676038213e-06,1,6.750143440548112e-06,0,141.29400249755312
1582,mug,1,2.797476676038213e-06,1,6.750143440548112e-06,0,141.29400249755312
1583,lighter,1,2.797476676038213e-06,1,6.750143440548112e-06,0,141.29400249755312
1584,lard,1,2.797476676038213e-06,1,6.750143440548112e-06,0,141.29400249755312
1585,graphic,1,2.797476676038213e-06,1,6.750143440548112e-06,0,141.29400249755312
1586,nailed,1,2.797476676038213e-06,1,6.750143440548112e-06,0,141.29400249755312
1587,arrows,1,2.797476676038213e-06,1,6.750143440548112e-06,0,141.29400249755312
1588,staple,1,2.797476676038213e-06,1,6.750143440548112e-06,0,141.29400249755312
1589,batteries,1,2.797476676038213e-06,1,6.750143440548112e-06,0,141.29400249755312
1590,twoway,1,2.797476676038213e-06,1,6.750143440548112e-06,0,141.29400249755312
1591,clip,1,2.797476676038213e-06,1,6.750143440548112e-06,0,141.29400249755312
1592,accordionfolded,1,2.797476676038213e-06,1,6.750143440548112e-06,0,141.29400249755312
1593,designed,1,2.797476676038213e-06,1,6.750143440548112e-06,0,141.29400249755312
1594,liquor,1,2.797476676038213e-06,1,6.750143440548112e-06,0,141.29400249755312
1595,dvdr,1,2.797476676038213e-06,1,6.750143440548112e-06,0,141.29400249755312
1596,openings,1,2.797476676038213e-06,1,6.750143440548112e-06,0,141.29400249755312
1597,lightbulb,1,2.797476676038213e-06,1,6.750143440548112e-06,0,141.29400249755312
1598,sevenchannel,1,2.797476676038213e-06,1,6.750143440548112e-06,0,141.29400249755312
1599,velcro,1,2.797476676038213e-06,1,6.750143440548112e-06,0,141.29400249755312
1600,umatic,1,2.797476676038213e-06,1,6.750143440548112e-06,0,141.29400249755312
1601,videotape,1,2.797476676038213e-06,1,6.750143440548112e-06,0,141.29400249755312
1602,vcr,1,2.797476676038213e-06,1,6.750143440548112e-06,0,141.29400249755312
1603,ashes,1,2.797476676038213e-06,1,6.750143440548112e-06,0,141.29400249755312
1604,items,1,2.797476676038213e-06,1,6.750143440548112e-06,0,141.29400249755312
1605,pasta,1,2.797476676038213e-06,1,6.750143440548112e-06,0,141.29400249755312
1606,jewel,1,2.797476676038213e-06,1,6.750143440548112e-06,0,141.29400249755312
1607,pouch,1,2.797476676038213e-06,1,6.750143440548112e-06,0,141.29400249755312
1608,partial,1,2.797476676038213e-06,1,6.750143440548112e-06,0,141.29400249755312
1609,matchbook,1,2.797476676038213e-06,1,6.750143440548112e-06,0,141.29400249755312
1610,keychain,1,2.797476676038213e-06,1,6.750143440548112e-06,0,141.29400249755312
1611,bottomless,1,2.797476676038213e-06,1,6.750143440548112e-06,0,141.29400249755312
1612,maker,1,2.797476676038213e-06,1,6.750143440548112e-06,0,141.29400249755312
1613,fake,1,2.797476676038213e-06,1,6.750143440548112e-06,0,141.29400249755312
1614,thumb,1,2.797476676038213e-06,1,6.750143440548112e-06,0,141.29400249755312
1615,banana,1,2.797476676038213e-06,1,6.750143440548112e-06,0,141.29400249755312
1616,pump,1,2.797476676038213e-06,1,6.750143440548112e-06,0,141.29400249755312
1617,truck,1,2.797476676038213e-06,1,6.750143440548112e-06,0,141.29400249755312
1618,photographers,1,2.797476676038213e-06,1,6.750143440548112e-06,0,141.29400249755312
1619,mini,1,2.797476676038213e-06,1,6.750143440548112e-06,0,141.29400249755312
1620,xeroxed,1,2.797476676038213e-06,1,6.750143440548112e-06,0,141.29400249755312
1621,bee,1,2.797476676038213e-06,1,6.750143440548112e-06,0,141.29400249755312
1622,boy,1,2.797476676038213e-06,1,6.750143440548112e-06,0,141.29400249755312
1623,birds,1,2.797476676038213e-06,1,6.750143440548112e-06,0,141.29400249755312
1624,sea,1,2.797476676038213e-06,1,6.750143440548112e-06,0,141.29400249755312
1625,abraham,1,2.797476676038213e-06,1,6.750143440548112e-06,0,141.29400249755312
1626,ruled,1,2.797476676038213e-06,1,6.750143440548112e-06,0,141.29400249755312
1627,permanently,1,2.797476676038213e-06,1,6.750143440548112e-06,0,141.29400249755312
1628,fortynine,1,2.797476676038213e-06,1,6.750143440548112e-06,0,141.29400249755312
1629,deluxe,1,2.797476676038213e-06,1,6.750143440548112e-06,0,141.29400249755312
1630,fabriano,1,2.797476676038213e-06,1,6.750143440548112e-06,0,141.29400249755312
1631,fortyone,1,2.797476676038213e-06,1,6.750143440548112e-06,0,141.29400249755312
1632,iillustrated,1,2.797476676038213e-06,1,6.750143440548112e-06,0,141.29400249755312
1633,armchair,1,2.797476676038213e-06,1,6.750143440548112e-06,0,141.29400249755312
1634,chapter,1,2.797476676038213e-06,1,6.750143440548112e-06,0,141.29400249755312
1635,screenprints\r\n,1,2.797476676038213e-06,1,6.750143440548112e-06,0,141.29400249755312
1636,peacock,1,2.797476676038213e-06,1,6.750143440548112e-06,0,141.29400249755312
1637,spider,1,2.797476676038213e-06,1,6.750143440548112e-06,0,141.29400249755312
1638,sketches,1,2.797476676038213e-06,1,6.750143440548112e-06,0,141.29400249755312
1639,sur,1,2.797476676038213e-06,1,6.750143440548112e-06,0,141.29400249755312
1640,bois,1,2.797476676038213e-06,1,6.750143440548112e-06,0,141.29400249755312
1641,grasses,1,2.797476676038213e-06,1,6.750143440548112e-06,0,141.29400249755312
1642,lexan,1,2.797476676038213e-06,1,6.750143440548112e-06,0,141.29400249755312
1643,feet,1,2.797476676038213e-06,1,6.750143440548112e-06,0,141.29400249755312
1644,jersey,1,2.797476676038213e-06,1,6.750143440548112e-06,0,141.29400249755312
1645,braided,1,2.797476676038213e-06,1,6.750143440548112e-06,0,141.29400249755312
1646,fill,1,2.797476676038213e-06,1,6.750143440548112e-06,0,141.29400249755312
1647,scoring,1,2.797476676038213e-06,1,6.750143440548112e-06,0,141.29400249755312
1648,print\r\nb,1,2.797476676038213e-06,1,6.750143440548112e-06,0,141.29400249755312
1649,print\r\nc,1,2.797476676038213e-06,1,6.750143440548112e-06,0,141.29400249755312
1650,paper\r\na,1,2.797476676038213e-06,1,6.750143440548112e-06,0,141.29400249755312
1651,diazoprint,1,2.797476676038213e-06,1,6.750143440548112e-06,0,141.29400249755312
1652,meal,1,2.797476676038213e-06,1,6.750143440548112e-06,0,141.29400249755312
1653,low,1,2.797476676038213e-06,1,6.750143440548112e-06,0,141.29400249755312
1654,matrix,1,2.797476676038213e-06,1,6.750143440548112e-06,0,141.29400249755312
1655,rag,1,2.797476676038213e-06,1,6.750143440548112e-06,0,141.29400249755312
1656,flourescent,1,2.797476676038213e-06,1,6.750143440548112e-06,0,141.29400249755312
1657,blowup,1,2.797476676038213e-06,1,6.750143440548112e-06,0,141.29400249755312
1658,public,1,2.797476676038213e-06,1,6.750143440548112e-06,0,141.29400249755312
1659,bundles,1,2.797476676038213e-06,1,6.750143440548112e-06,0,141.29400249755312
1660,underside,1,2.797476676038213e-06,1,6.750143440548112e-06,0,141.29400249755312
1661,photolithography,1,2.797476676038213e-06,1,6.750143440548112e-06,0,141.29400249755312
1662,sketch,1,2.797476676038213e-06,1,6.750143440548112e-06,0,141.29400249755312
1663,michel,1,2.797476676038213e-06,1,6.750143440548112e-06,0,141.29400249755312
1664,typography,1,2.797476676038213e-06,1,6.750143440548112e-06,0,141.29400249755312
1665,moulded,1,2.797476676038213e-06,1,6.750143440548112e-06,0,141.29400249755312
1666,floss,1,2.797476676038213e-06,1,6.750143440548112e-06,0,141.29400249755312
1667,glassreinforced,1,2.797476676038213e-06,1,6.750143440548112e-06,0,141.29400249755312
1668,mirrorpolished,1,2.797476676038213e-06,1,6.750143440548112e-06,0,141.29400249755312
1669,makrolon,1,2.797476676038213e-06,1,6.750143440548112e-06,0,141.29400249755312
1670,density,1,2.797476676038213e-06,1,6.750143440548112e-06,0,141.29400249755312
1671,slipcast,1,2.797476676038213e-06,1,6.750143440548112e-06,0,141.29400249755312
1672,felted,1,2.797476676038213e-06,1,6.750143440548112e-06,0,141.29400249755312
1673,liner,1,2.797476676038213e-06,1,6.750143440548112e-06,0,141.29400249755312
1674,strung,1,2.797476676038213e-06,1,6.750143440548112e-06,0,141.29400249755312
1675,spacers,1,2.797476676038213e-06,1,6.750143440548112e-06,0,141.29400249755312
1676,woodfired,1,2.797476676038213e-06,1,6.750143440548112e-06,0,141.29400249755312
1677,incandescent,1,2.797476676038213e-06,1,6.750143440548112e-06,0,141.29400249755312
1678,trim,1,2.797476676038213e-06,1,6.750143440548112e-06,0,141.29400249755312
1679,fused,1,2.797476676038213e-06,1,6.750143440548112e-06,0,141.29400249755312
1680,silica,1,2.797476676038213e-06,1,6.750143440548112e-06,0,141.29400249755312
1681,offet,1,2.797476676038213e-06,1,6.750143440548112e-06,0,141.29400249755312
1682,fourpart,1,2.797476676038213e-06,1,6.750143440548112e-06,0,141.29400249755312
1683,amd,1,2.797476676038213e-06,1,6.750143440548112e-06,0,141.29400249755312
1684,shredded,1,2.797476676038213e-06,1,6.750143440548112e-06,0,141.29400249755312
1685,saucer,1,2.797476676038213e-06,1,6.750143440548112e-06,0,141.29400249755312
1686,roof,1,2.797476676038213e-06,1,6.750143440548112e-06,0,141.29400249755312
1687,carrara,1,2.797476676038213e-06,1,6.750143440548112e-06,0,141.29400249755312
1688,large,1,2.797476676038213e-06,1,6.750143440548112e-06,0,141.29400249755312
1689,pipes,1,2.797476676038213e-06,1,6.750143440548112e-06,0,141.29400249755312
1690,tennessee,1,2.797476676038213e-06,1,6.750143440548112e-06,0,141.29400249755312
1691,unfired,1,2.797476676038213e-06,1,6.750143440548112e-06,0,141.29400249755312
1692,oval,1,2.797476676038213e-06,1,6.750143440548112e-06,0,141.29400249755312
1693,pendulum,1,2.797476676038213e-06,1,6.750143440548112e-06,0,141.29400249755312
1694,suspension,1,2.797476676038213e-06,1,6.750143440548112e-06,0,141.29400249755312
1695,beams,1,2.797476676038213e-06,1,6.750143440548112e-06,0,141.29400249755312
1696,zippers,1,2.797476676038213e-06,1,6.750143440548112e-06,0,141.29400249755312
1697,cradle,1,2.797476676038213e-06,1,6.750143440548112e-06,0,141.29400249755312
1698,panes,1,2.797476676038213e-06,1,6.750143440548112e-06,0,141.29400249755312
1699,necktie,1,2.797476676038213e-06,1,6.750143440548112e-06,0,141.29400249755312
1700,interleaved,1,2.797476676038213e-06,1,6.750143440548112e-06,0,141.29400249755312
1701,part,1,2.797476676038213e-06,1,6.750143440548112e-06,0,141.29400249755312
1702,tshirt,1,2.797476676038213e-06,1,6.750143440548112e-06,0,141.29400249755312
1703,garment,1,2.797476676038213e-06,1,6.750143440548112e-06,0,141.29400249755312
1704,quilt,1,2.797476676038213e-06,1,6.750143440548112e-06,0,141.29400249755312
1705,pumice,1,2.797476676038213e-06,1,6.750143440548112e-06,0,141.29400249755312
1706,along,1,2.797476676038213e-06,1,6.750143440548112e-06,0,141.29400249755312
1707,buckles,1,2.797476676038213e-06,1,6.750143440548112e-06,0,141.29400249755312
1708,eucalyptus,1,2.797476676038213e-06,1,6.750143440548112e-06,0,141.29400249755312
1709,sized,1,2.797476676038213e-06,1,6.750143440548112e-06,0,141.29400249755312
1710,faux,1,2.797476676038213e-06,1,6.750143440548112e-06,0,141.29400249755312
1711,composed,1,2.797476676038213e-06,1,6.750143440548112e-06,0,141.29400249755312
1712,gypsum,1,2.797476676038213e-06,1,6.750143440548112e-06,0,141.29400249755312
1713,holder,1,2.797476676038213e-06,1,6.750143440548112e-06,0,141.29400249755312
1714,refrigerator,1,2.797476676038213e-06,1,6.750143440548112e-06,0,141.29400249755312
1715,polmer,1,2.797476676038213e-06,1,6.750143440548112e-06,0,141.29400249755312
1716,foot,1,2.797476676038213e-06,1,6.750143440548112e-06,0,141.29400249755312
1717,circular,1,2.797476676038213e-06,1,6.750143440548112e-06,0,141.29400249755312
1718,twigs,1,2.797476676038213e-06,1,6.750143440548112e-06,0,141.29400249755312
1719,clamps,1,2.797476676038213e-06,1,6.750143440548112e-06,0,141.29400249755312
1720,easel,1,2.797476676038213e-06,1,6.750143440548112e-06,0,141.29400249755312
1721,driftwood,1,2.797476676038213e-06,1,6.750143440548112e-06,0,141.29400249755312
1722,pack,1,2.797476676038213e-06,1,6.750143440548112e-06,0,141.29400249755312
1723,bowls,1,2.797476676038213e-06,1,6.750143440548112e-06,0,141.29400249755312
1724,branch,1,2.797476676038213e-06,1,6.750143440548112e-06,0,141.29400249755312
1725,eyeglass,1,2.797476676038213e-06,1,6.750143440548112e-06,0,141.29400249755312
1726,hydrocal,1,2.797476676038213e-06,1,6.750143440548112e-06,0,141.29400249755312
1727,gneiss,1,2.797476676038213e-06,1,6.750143440548112e-06,0,141.29400249755312
1728,garter,1,2.797476676038213e-06,1,6.750143440548112e-06,0,141.29400249755312
1729,hollow,1,2.797476676038213e-06,1,6.750143440548112e-06,0,141.29400249755312
1730,hanging,1,2.797476676038213e-06,1,6.750143440548112e-06,0,141.29400249755312
1731,casting,1,2.797476676038213e-06,1,6.750143440548112e-06,0,141.29400249755312
1732,element,1,2.797476676038213e-06,1,6.750143440548112e-06,0,141.29400249755312
1733,timer,1,2.797476676038213e-06,1,6.750143440548112e-06,0,141.29400249755312
1734,intervals,1,2.797476676038213e-06,1,6.750143440548112e-06,0,141.29400249755312
1735,cinder,1,2.797476676038213e-06,1,6.750143440548112e-06,0,141.29400249755312
1736,fragment,1,2.797476676038213e-06,1,6.750143440548112e-06,0,141.29400249755312
1737,bus,1,2.797476676038213e-06,1,6.750143440548112e-06,0,141.29400249755312
1738,bicycle,1,2.797476676038213e-06,1,6.750143440548112e-06,0,141.29400249755312
1739,faucet,1,2.797476676038213e-06,1,6.750143440548112e-06,0,141.29400249755312
1740,knobs,1,2.797476676038213e-06,1,6.750143440548112e-06,0,141.29400249755312
1741,bullets,1,2.797476676038213e-06,1,6.750143440548112e-06,0,141.29400249755312
1742,corn,1,2.797476676038213e-06,1,6.750143440548112e-06,0,141.29400249755312
1743,rulers,1,2.797476676038213e-06,1,6.750143440548112e-06,0,141.29400249755312
1744,corten,1,2.797476676038213e-06,1,6.750143440548112e-06,0,141.29400249755312
1745,\,1,2.797476676038213e-06,1,6.750143440548112e-06,0,141.29400249755312
1746,tools,1,2.797476676038213e-06,1,6.750143440548112e-06,0,141.29400249755312
1747,collar,1,2.797476676038213e-06,1,6.750143440548112e-06,0,141.29400249755312
1748,plank,1,2.797476676038213e-06,1,6.750143440548112e-06,0,141.29400249755312
1749,jewelry,1,2.797476676038213e-06,1,6.750143440548112e-06,0,141.29400249755312
1750,n,1,2.797476676038213e-06,1,6.750143440548112e-06,0,141.29400249755312
1751,scratched,1,2.797476676038213e-06,1,6.750143440548112e-06,0,141.29400249755312
1752,board\r\n\r\n,1,2.797476676038213e-06,1,6.750143440548112e-06,0,141.29400249755312
1753,treated,1,2.797476676038213e-06,1,6.750143440548112e-06,0,141.29400249755312
1754,coffee,1,2.797476676038213e-06,1,6.750143440548112e-06,0,141.29400249755312
1755,filter,1,2.797476676038213e-06,1,6.750143440548112e-06,0,141.29400249755312
1756,abrasive,1,2.797476676038213e-06,1,6.750143440548112e-06,0,141.29400249755312
1757,ninety,1,2.797476676038213e-06,1,6.750143440548112e-06,0,141.29400249755312
1758,exposure,1,2.797476676038213e-06,1,6.750143440548112e-06,0,141.29400249755312
1759,er,1,2.797476676038213e-06,1,6.750143440548112e-06,0,141.29400249755312
1760,master,1,2.797476676038213e-06,1,6.750143440548112e-06,0,141.29400249755312
1761,june,1,2.797476676038213e-06,1,6.750143440548112e-06,0,141.29400249755312
1762,stitched,1,2.797476676038213e-06,1,6.750143440548112e-06,0,141.29400249755312
1763,april,1,2.797476676038213e-06,1,6.750143440548112e-06,0,141.29400249755312
1764,fixative,1,2.797476676038213e-06,1,6.750143440548112e-06,0,141.29400249755312
1765,dirt,1,2.797476676038213e-06,1,6.750143440548112e-06,0,141.29400249755312
1766,figurines,1,2.797476676038213e-06,1,6.750143440548112e-06,0,141.29400249755312
1767,cutandtorn,1,2.797476676038213e-06,1,6.750143440548112e-06,0,141.29400249755312
1768,doily,1,2.797476676038213e-06,1,6.750143440548112e-06,0,141.29400249755312
1769,additions\r\n\r\n,1,2.797476676038213e-06,1,6.750143440548112e-06,0,141.29400249755312
1770,talcum,1,2.797476676038213e-06,1,6.750143440548112e-06,0,141.29400249755312
1771,paintstik,1,2.797476676038213e-06,1,6.750143440548112e-06,0,141.29400249755312
1772,preceding,1,2.797476676038213e-06,1,6.750143440548112e-06,0,141.29400249755312
1773,address,1,2.797476676038213e-06,1,6.750143440548112e-06,0,141.29400249755312
1774,copal,1,2.797476676038213e-06,1,6.750143440548112e-06,0,141.29400249755312
1775,wings,1,2.797476676038213e-06,1,6.750143440548112e-06,0,141.29400249755312
1776,sample,1,2.797476676038213e-06,1,6.750143440548112e-06,0,141.29400249755312
1777,ties,1,2.797476676038213e-06,1,6.750143440548112e-06,0,141.29400249755312
1778,screeprint,1,2.797476676038213e-06,1,6.750143440548112e-06,0,141.29400249755312
1779,stipple,1,2.797476676038213e-06,1,6.750143440548112e-06,0,141.29400249755312
1780,seal,1,2.797476676038213e-06,1,6.750143440548112e-06,0,141.29400249755312
1781,seals,1,2.797476676038213e-06,1,6.750143440548112e-06,0,141.29400249755312
1782,mannequin,1,2.797476676038213e-06,1,6.750143440548112e-06,0,141.29400249755312
1783,technique,1,2.797476676038213e-06,1,6.750143440548112e-06,0,141.29400249755312
1784,bite,1,2.797476676038213e-06,1,6.750143440548112e-06,0,141.29400249755312
1785,capsule,1,2.797476676038213e-06,1,6.750143440548112e-06,0,141.29400249755312
1786,la,1,2.797476676038213e-06,1,6.750143440548112e-06,0,141.29400249755312
1787,poupée,1,2.797476676038213e-06,1,6.750143440548112e-06,0,141.29400249755312
1788,crisbrook,1,2.797476676038213e-06,1,6.750143440548112e-06,0,141.29400249755312
1789,waterleaf,1,2.797476676038213e-06,1,6.750143440548112e-06,0,141.29400249755312
1790,varying,1,2.797476676038213e-06,1,6.750143440548112e-06,0,141.29400249755312
1791,à,1,2.797476676038213e-06,1,6.750143440548112e-06,0,141.29400249755312
1792,final,1,2.797476676038213e-06,1,6.750143440548112e-06,0,141.29400249755312
1793,handkerchief,1,2.797476676038213e-06,1,6.750143440548112e-06,0,141.29400249755312
1794,etching\r\n,1,2.797476676038213e-06,1,6.750143440548112e-06,0,141.29400249755312
1795,sixtyfive,1,2.797476676038213e-06,1,6.750143440548112e-06,0,141.29400249755312
1796,deep,1,2.797476676038213e-06,1,6.750143440548112e-06,0,141.29400249755312
1797,solar,1,2.797476676038213e-06,1,6.750143440548112e-06,0,141.29400249755312
1798,sienna,1,2.797476676038213e-06,1,6.750143440548112e-06,0,141.29400249755312
1799,embossing\r\n,1,2.797476676038213e-06,1,6.750143440548112e-06,0,141.29400249755312
1800,acyrlic,1,2.797476676038213e-06,1,6.750143440548112e-06,0,141.29400249755312
1801,spraypainted,1,2.797476676038213e-06,1,6.750143440548112e-06,0,141.29400249755312
1802,liftground,1,2.797476676038213e-06,1,6.750143440548112e-06,0,141.29400249755312
1803,slot,1,2.797476676038213e-06,1,6.750143440548112e-06,0,141.29400249755312
1804,packages,1,2.797476676038213e-06,1,6.750143440548112e-06,0,141.29400249755312
1805,chamois,1,2.797476676038213e-06,1,6.750143440548112e-06,0,141.29400249755312
1806,processed,1,2.797476676038213e-06,1,6.750143440548112e-06,0,141.29400249755312
1807,pills,1,2.797476676038213e-06,1,6.750143440548112e-06,0,141.29400249755312
1808,collè,1,2.797476676038213e-06,1,6.750143440548112e-06,0,141.29400249755312
1809,create,1,2.797476676038213e-06,1,6.750143440548112e-06,0,141.29400249755312
1810,scotch,1,2.797476676038213e-06,1,6.750143440548112e-06,0,141.29400249755312
1811,fire,1,2.797476676038213e-06,1,6.750143440548112e-06,0,141.29400249755312
1812,bristle,1,2.797476676038213e-06,1,6.750143440548112e-06,0,141.29400249755312
1813,sulphur,1,2.797476676038213e-06,1,6.750143440548112e-06,0,141.29400249755312
1814,engraving\r\n,1,2.797476676038213e-06,1,6.750143440548112e-06,0,141.29400249755312
1815,butter,1,2.797476676038213e-06,1,6.750143440548112e-06,0,141.29400249755312
1816,licorice,1,2.797476676038213e-06,1,6.750143440548112e-06,0,141.29400249755312
